Ce, Ce, Ce, Ce, Gg, Xos, Xos, Xos, Xos, Xos, Cud, Xos, Xos, Xos, Xos, Xos, Xos, Xos, Xos, Xos, Xos, Xos
Ce, Ce, 1 Ke, Ce, Gg, Xos, Xos, Xos, Xos, Xos, Cud, Xos, Xos, Xos, Xos, Xos, Xos, Xos, Xos, Xos, Xos, Xos
Ce, Ce, Ce, Ce, Gg, Xos, Xos, Xos, Xos, 2 Kud, Cud, Re, Re, Xos, Xos, Xos, Xos, Xos, Xos, Xos, Xos, Xos
Gg, Gg, Rr, Rr, Gg, Xos, Xos, Xos, Xos, Xos, Xos, Re, Re, Re, Re, Xos, Xos, Xos, Xos, Xos, Xos, Xos
Gg, Gg, Rr, Rr, Gg, Gg, Gg, Xos, Gg, Xos, Gg, Xos, Gg, Re, Re, Xos, Xos, Xos, Xos, Xos, Xos, Xos
Gg, Gg, Rr, Rr, Rr, Gg, Rr, Gg, Rr, Gg, Rr, Gg, Rr, Gg, Gg, Xos, Xos, Xos, Xos, Xos, Xos, Xos
Gg, Gg, Re, Rr, Rr, Rr, Rr, Rr, Rr, Rr, Rr, Rr, Rr, Rr, Rr, Gg, Gg, Xos, Xos, Xos, Xos, Xos
Re, Re, Gg, Gg, Gg, Rr, Gg, Rr, Gg, Rr, Gg, Rr, Gg, Rr, Rr, Rr, Rr, Gg, Gg, Xos, Gg, Gg
Re, Re, Gg, Xos, Xos, Gg, Xos, Gg, Xos, Gg, Xos, Gg, Xos, Gg, Gg, Rr, Rr, Rr, Rr, Gg, Rr, Rr
Re, Re, Re, Xos, Cud, Xos, Xos, Xos, Xos, Xos, Xos, Xos, Xos, Xos, Xos, Gg, Gg, Rr, Rr, Rr, Rr, Rr
Re, Re, Re, Cud, 3 Kud, Cud, Re, Re, Re, Xos, Xos, Xos, Xos, Xos, Xos, Xos, Xos, Gg, Rr, Rr, Rr, Rr
Xos, Xos, Xos, Cud, Xos, Cud, Xos, Re, Re, Xos, Xos, Xos, Xos, Xos, Xos, Xos, Xos, Gg, Rr, Rr, Rr, Rr
Xos, Xos, Gg, Xos, Gg, Xos, Xos, Re, Gg, Gg, Gg, Xos, Gg, Xos, Gg, Xos, Gg, Gg, Rr, Rr, Rr, Rr
Re, Re, Gg, Gg, Gg, Gg, Gg, Gg, Rr, Gg, Rr, Gg, Rr, Gg, Rr, Gg, Rr, Rr, Rr, Rr, Rr, Rr
Re, Re, Rr, Gg, Rr, Rr, Rr, Rr, Rr, Rr, Rr, Rr, Rr, Rr, Rr, Rr, Rr, Rr, Gg, Gg, Gg, Gg
Rr, Rr, Rr, Rr, Ce, Ce, Ce, Rr, Gg, Rr, Gg, Rr, Gg, Rr, Gg, Rr, Gg, Gg, Xos, Xos, Xos, Xos
Gg, Gg, Gg^Vh, Rr, Ce, Ke, Ce, Rr, Gg, Gg, Xos, Gg, Xos, Gg, Xos, Gg, Re, Re, Re, Xos, Xos, Xos
Ww^Bw/, Ww^Bw/, Ww, Gg, Gg^Vh, Ce, Rr, Rr, Gg, Xos, Xos, Xos, Xos, Xos, Re, Re, Re, Re, Xos, Xos, Xos, Xos
Ww, Ww, Ww^Bw/, Ww^Bw/, Ww, Gg, Gg^Vh, Rr, Gg, Xos, Xos, Xos, 4 Kud, Cud, Cud, Re, Xos, Xos, Xos, Xos, Xos, Xos
Ww, Ww, Ww, Ww, Ww^Bw/, Ww^Bw/, Ww, Gg, Gg, Xos, Xos, Xos, Xos, Cud, Xos, Xos, Xos, Xos, Xos, Xos, Xos, Xos
Ww, Ww, Ww, Ww, Ww, Ww, Ww, Gg, Gg, Gg, Gg, Xos, Xos, Xos, Xos, Xos, Xos, Xos, Xos, Xos, Xos, Xos
Ww, Ww, Ww, Ww, Ww, Ww, Ww, Gg, Gg, Gg, Gg, Xos, Xos, Xos, Xos, Xos, Xos, Xos, Xos, Xos, Xos, Xos
