Gs, Gs, Gs, Gs, Rb, Xos, Xos, Xos, Xos, Xos, Xos, Xos, Xos, Xos, Xos, Xos, Xos, Xos, Xos, Xos, Xos, Xos
Gs, 1 Ke, Ce, Ce, Gg, Xos, Xos, Xos, Xos, Xos, 2 Kud, Xos, Xos, Xos, Xos, Xos, Xos, Xos, Xos, Xos, Xos, Xos
Gs, Ce, Ce, Ke, Gg, Xos, Xos, Xos, Xos, Cud, Cud, Rd, Rd, Xos, Xos, Xos, Xos, Xos, Xos, Xos, Xos, Xos
Gg, Rb^Vct, Rrc, Rrc, Gg, Xos, Xos, Xos, Xos, Xos, Xos, Gg, Rd, Gg, Gg, Xos, Xos, Xos, Xos, Xos, Xos, Xos
Gg, Rb, Rrc, Rrc, Gg, Gg, Gg, Xos, Gg, Xos, Gg, Xos, Gg, Rd, Gg, Xos, Xos, Xos, Xos, Xos, Xos, Xos
Gg, Gg, Rrc, Rrc, Rrc, Gg^Fet, Rrc, Gg, Rrc, Gg, Rrc, Gg, Rrc, Rd, Gg, Xos, Xos, Xos, Xos, Xos, Xos, Xos
Gg, Gg, Rd, Rrc, Rrc, Rrc, Rrc, Rrc, Rrc, Rrc, Rrc, Rrc, Rrc, Rrc, Rrc, Gg, Gg, Xos, Xos, Xos, Xos, Xos
Rd, Rd, Gg, Gg, Gg, Rrc, Gg, Rrc, Gg, Rrc, Gg, Rrc, Gg, Rrc, Rrc, Rrc, Rrc, Gg, Gg, Xos, Gg, Gg
Gg, Rd, Gg, Xos, Xos, Gg, Xos, Gg, Xos, Gg, Xos, Gg, Xos, Gg, Gg, Rrc, Rrc, Rrc, Rrc, Gg, Rrc, Rrc
Gg, Rd, Gg, Xos, Cud, Xos, Xos, Xos, Xos, Xos, Xos, Xos, Xos, Xos, Xos, Gg, Gg, Rrc, Rrc, Rrc, Rrc, Rrc
Gg, Rd, Rd, Cud, 3 Kud, Cud, Rd, Gg, Gg, Xos, Xos, Xos, Xos, Xos, Xos, Xos, Xos, Gg, Rrc, Rrc, Rrc, Rrc
Xos, Xos, Xos, Cud, Xos, Cud, Xos, Rd, Gg, Xos, Xos, Xos, Xos, Xos, Xos, Xos, Xos, Gg, Rrc, Rrc, Rrc, Rrc
Xos, Xos, Gg, Xos, Xos, Xos, Xos, Rd, Rd, Gg, Gg, Xos, Gg, Xos, Gg, Xos, Gg, Gg, Rrc, Rrc, Rrc, Rrc
Re^Gvs, Re^Gvs, Gg, Gg, Gg, Gg, Gg, Gg, Rrc, Gg, Rrc, Gg, Rrc, Gg, Rrc, Gg, Rrc, Rrc, Rrc, Rrc, Rrc, Rrc
Re^Gvs, Re^Gvs, Rrc, Gg^Fet, Rrc, Rrc, Rrc, Rrc, Rrc, Rrc, Rrc, Rrc, Rrc, Rrc, Rrc, Rrc, Rrc, Rrc, Gg, Gg, Gg, Gg
Rrc, Rrc, Rrc, Rrc, Ce, Rrc, Ce, Rrc, Gg^Fet, Rrc, Gg, Rrc, Gg, Rrc, Gg, Rrc, Gg, Rd, Xos, Xos, Xos, Xos
Gg, Rb, Rrc^Vhc, Rr, Rrc, Ce, Ke, Rrc, Gg, Gg, Xos, Gg, Xos, Gg, Xos, Gg, Rd, Rd, Gg, Xos, Xos, Xos
Wwg^Bsb/, Wwg^Bsb/, Wwg, Rr, Rr^Vhc, Ce, Rrc, Rp, Gg, Xos, Xos, Xos, Xos, Xos, Gg, Gg, Rd, Gg, Xos, Xos, Xos, Xos
Wog, Wog, Wwg^Bsb/, Wwg^Bsb/, Wwrg, Rr, Rr^Vhc, Rrc, Gg, Xos, Xos, Xos, Cud, Cud, Cud, Rd, Xos, Xos, Xos, Xos, Xos, Xos
Wog, Wog^Bsd, Wog, Wog, Wwg^Bsb/, Wwg^Bsb/, Wwg^Bsd, Rb, Gg, Xos, Xos, Xos, Xos, 4 Kud, Xos, Xos, Xos, Xos, Xos, Xos, Xos, Xos
Wog, Wog, Wog, Wog^Bsd, Wog, Wog, Wwg, Gg, Gg, Gg, Hd^Dr, Xos, Xos, Xos, Xos, Xos, Xos, Xos, Xos, Xos, Xos, Xos
Wog, Wog, Ww, Wog, Wog, Wog, Wwg, Rb, Gg, Gg, Gg, Xos, Xos, Xos, Xos, Xos, Xos, Xos, Xos, Xos, Xos, Xos
