Wo, Wo, Wo, Wo, Wo, Wo, Wo, Wo, Wo, Wo, Wo, Wo, Wo, Wo, Wo, Wo, Wo, Wo, Wo, Wo, Wo, Wo, Wo, Wo, Wo, Wo
Wo, Wo, Wo, Wo, Wo, Wo, Wo, Wo, Wo, Wo, Wo, Wo, Wo, Wo, Wo, Wo, Wo, Wo, Wo, Wo, Wo, Wo, Wo, Wo, Wo, Wo
Wo, Wo, Wo, Wo, Wo, Wo, Wo, Wo, Wo, Wo, Wo, Wo, Wo, Wo, Wo, Wo, Wo, Wo, Wo, Wo, Wo, Wo, Wo, Wo, Wo, Wo
Wo, Wo, Wo, Wo, Wo, Wo, Wo, Wo, Wo, Wo, Wo, Wo, Wo, Wo, Wo, Wo, Wo, Wo, Wo, Wo, Wo, Wo, Wo, Wo, Wo, Wo
Wo, Wo, Wo, Wo, Wo, Wo, Wo, Wo, Wo, Wo, Wo, Wo, Wo, Wo, Wo, Wo, Rr, Xom, Xom, Wo, Wo, Wo, Wo, Wo, Wo, Wo
Wo, Wo, Wo, Wo, Wo, Wo, Wo, Wo, Wo, Wo, Wo, Wo, Wo, Wo, Rr, Rr, Ce, Icn, Icn^Vyb, Xom, Wo, Wo, Wo, Wo, Wo, Wo
Wo, Wo, Wo, Wo, Wo, Wo, Wo, Wo, Wo, Wo, Wo, Wo, Rr, Rr, Ior, Ce, 1 Ke, Ce, Icn, Xom, Wo, Wo, Wo, Wo, Wo, Wo
Wo, Wo, Wo, Wo, Wo, Wo, Wo, Wo, Wo, Wo, Rr, Rr, Ior, Ior, Ior, Ce, Ce, Ce, Rr^Vyb, Xom, Wo, Wo, Wo, Wo, Wo, Wo
Wo, Wo, Wo, Wo, Wo, Wo, Wo, Wo, Rr, Rr, Ior, Ior, Xom, Ior, Ior, Ior, Rr^Vyb, Rr, Wo, Wo, Wo, Wo, Wo, Wo, Wo, Wo
Wo, Wo, Wo, Wo, Wo, Wo, Xom, Rr, Ior, Ior, Ior, Ior, Ior, Ior, Rr^Vyb, Rr, Wo^Bp|, Wo, Wo, Wo, Wo, Wo, Wo, Wo, Wo, Wo
Wo, Wo, Wo, Wo, Wo, Wo, Xom, Ior, Ior, Xom, Ior, Ior, Rr^Vyb, Rr, Wo^Bp|, Wo, Wo^Bp|, Wo, Wo, Wo, Wo, Wo, Wo, Wo, Wo, Wo
Wo, Wo, Wo, Wo, Wo, Wo, Xom, Ior, Ior, Ior, Rr, Rr, Wo, Wo, Wo^Bp|, Wo, Wo^Bp|, Wo, Wo, Wo, Wo, Wo, Wo, Wo, Wo, Wo
Wo, Wo, Wo, Wo, Wo, Wo, Wo, Xom, Xom, Rr, Wo, Wo, Xom, Wo, Wo^Bp|, Wo, Wo^Bp|, Wo, Wo, Wo, Wo, Wo, Wo, Wo, Wo, Wo
Wo, Wo, Wo, Wo, Wo, Wo, Wo, Wo, Wo, Wo, Xom, Xom, Ior, Rr, Rr^Vyb, Wo, Wo^Bp|, Wo, Wo, Wo, Wo, Wo, Wo, Wo, Wo, Wo
Wo, Wo, Wo, Wo, Xom, Wo, Wo, Wo, Wo, Wo, Xom, Ior, Ior, Ior, Ior, Rr, Rr^Vyb, Wo, Wo, Wo, Wo, Wo, Wo, Wo, Wo, Wo
Wo, Wo, Xom, Xom, Ior, Xom, Xom, Wo, Wo, Wo, Xom, Ior, Ior, Xom, Ior, Ior, Ior, Rr, Rr, Wo, Wo, Wo, Wo, Wo, Wo, Wo
Wo, Wo, Rr, Ior, Ior, Ior, Rr, Wo, Wo, Wo, Wo^Bp/, Rr^Vyb, Rr, Ior, Ior, Ior, Xom, Ior, Ior, Rr, Rr, Wo, Wo, Wo, Wo, Wo
Wo, Wo, Rr, Ior, Xom, Ior, Rr, Wo, Wo^Bp/, Wo^Bp/, Wo, Wo, Wo^Bp/, Rr^Vyb, Rr, Ior, Ior, Ior, Ce, Ce, Ce, Rr, Xom, Wo, Wo, Wo
Wo, Wo, Rr, Ior, Ior, Ior, Rr^Vyb, Wo^Bp/, Wo, Wo, Wo^Bp/, Wo^Bp/, Wo, Wo, Wo, Rr, Rr, Ior, Ce, 2 Ke, Ce, Icn, Xom, Wo, Wo, Wo
Wo, Wo, Rr, Ior, Ce, Ior, Rr, Wo, Wo^Bp/, Wo^Bp/, Wo, Wo, Wo, Wo, Wo, Wo, Wo, Rr, Rr, Ce, Icn, Icn, Xom, Wo, Wo, Wo
Wo, Wo, Rr, Ce, 3 Ke, Ce, Rr^Vyb, Wo^Bp/, Wo, Wo, Wo, Wo, Wo, Wo, Wo, Wo, Wo, Wo, Wo, Rr, Xom, Xom, Wo, Wo, Wo, Wo
Wo, Wo, Rr, Ce, Ce, Ce, Rr, Wo, Wo, Wo, Wo, Wo, Wo, Wo, Wo, Wo, Wo, Wo, Wo, Wo, Wo, Wo, Wo, Wo, Wo, Wo
Wo, Wo, Xom, Ior, Ior, Ior, Xom, Wo, Wo, Wo, Wo, Wo, Wo, Wo, Wo, Wo, Wo, Wo, Wo, Wo, Wo, Wo, Wo, Wo, Wo, Wo
Wo, Wo, Wo, Xom, Xom, Xom, Wo, Wo, Wo, Wo, Wo, Wo, Wo, Wo, Wo, Wo, Wo, Wo, Wo, Wo, Wo, Wo, Wo, Wo, Wo, Wo
Wo, Wo, Wo, Wo, Wo, Wo, Wo, Wo, Wo, Wo, Wo, Wo, Wo, Wo, Wo, Wo, Wo, Wo, Wo, Wo, Wo, Wo, Wo, Wo, Wo, Wo
Wo, Wo, Wo, Wo, Wo, Wo, Wo, Wo, Wo, Wo, Wo, Wo, Wo, Wo, Wo, Wo, Wo, Wo, Wo, Wo, Wo, Wo, Wo, Wo, Wo, Wo
Wo, Wo, Wo, Wo, Wo, Wo, Wo, Wo, Wo, Wo, Wo, Wo, Wo, Wo, Wo, Wo, Wo, Wo, Wo, Wo, Wo, Wo, Wo, Wo, Wo, Wo
