Gg, Gg, Gg, Gg, Gs^Fp, Gs^Fp, Gs^Fp, Gs^Fp, Gs^Fp, Gs^Fp, Gg, Gg, Ss, Gg, Gg, Gs^Fp, Gs^Fp, Gs^Fp, Gs^Fp, Gs^Fp, Gs^Fp, Gs^Fp, Gs^Fp, Gg, Gg, Gg, Re, Re, Gg, Re, Re, Gg, Gs^Fp, Gs^Fp, Gs^Fp, Gs^Fp, Gs^Fp, Gs^Fp, Gs^Fp, Gs^Fp, Gs^Fp, Gg, Gg, Gg
Gg, Gg, Gg^Ve, Gg, Gs^Fp, Gs^Fp, Gs^Fp, Gs^Fp, Gs^Fp, Gs^Fp, Gg, Gg, Ss, Gg, Gg, Gs^Fp, Gs^Fp, Gs^Fp, Gs^Fp, Gs^Fp, Gs^Fp, Gs^Fp, Gs^Fp, Gg, Gg, Gg, Re, Re, Gg, Re, Re, Gg, Gs^Fp, Gs^Fp, Gs^Fp, Gs^Fp, Gs^Fp, Gs^Fp, Gs^Fp, Gs^Fp, Gs^Fp, Gg, Gg, Gg
Ds, Ds, Gg, Gg, Gs^Fp, Gs^Fp, Gs^Fp, Gs^Fp, Gs^Fp, Gs^Fp, Gg, Ds, Ss, Ss, Ss, Gg, Gg, Gs^Fp, Gs^Fp, Gs^Fp, Gg, Gs^Fp, Gg, Gg, Gg, Re, Ce, Ce, Ce, Gg^Ve, Re, Gg, Gs^Fp, Gs^Fp, Gs^Fp, Gs^Fp, Gs^Fp, Gs^Fp, Gs^Fp, Gs^Fp, Gs^Fp, Gg, Re, Re
Ds, Ds, Gg, Gg, Gs^Fp, Gs^Fp, Gs^Fp, Gs^Fp, Gg, Gg, Gg, Gg, Ds, Gg, Gg, Gs^Fp, Gs^Fp, Gg^Ve, Gg, Gs^Fp, Gg, Gg, Gg^Ve, Gg, Re, Re, Ce, 4 Ke, Ce, Gg, Gg, Re, Re, Gg, Gg, Gs^Fp, Gs^Fp, Gs^Fp, Gs^Fp, Gs^Fp, Re, Re, Gg, Gg
Ww, Ww, Gg, Gg, Gg, Gg, Gg, Gs^Fp, Gg, Gg^Ve, Ss, Ss, Gg, Ds, Gg, Ss, Ss, Ds, Gg, Gg, Gg, Gg, Gg, Gg, Re, Gg, Gg, Ce, Ss, Gg, Ds, Ds, Gg, Re, Re, Gg, Gs^Fp, Gs^Fp, Gs^Fp, Re, Gs^Fp, Gg, Gg, Gg
Ww, Ww, Ds, Gg, Gs^Fp, Gg^Ve, Gs^Fp, Gg, Ss, Ss, Ss, Ss, Ds, Gg, Ss, Ss, Gs^Fp, Ss, Ss, Ds, Ds, Gg, Gg, Re, Mm, Re, Gg, Gg, Ss, Ss, Ss, Ss, Gg^Ve, Gg, Gg, Re, Gg, Gs^Fp, Re, Re, Gs^Fp, Gg, Gg, Gg
Ds, Ds, Gg, Gg, Gs^Fp, Gg, Gs^Fp, Gg, Ds, Ss, Ss, Ss, Ss, Ss, Ss, Gg, Ds, Ss, Ss, Ss, Mm, Hh, Hh, Ch, Hh, Ch, Hh, Gg, Hh, Gg, Ss, Ss, Ss, Ss, Gg, Re, Re, Re, Gg, Gg, Gs^Fp, Gg, Gg, Gg
Ds, Ds, Gg, Gg, Gs^Fp, Gs^Fp, Gs^Fp, Gs^Fp, Gg, Ds, Ss, Gs^Fp, Ds, Ss, Gg, Ds, Ds, Ss, Ds, Hh, Ww, Ds, Ww, Ww^Bw|, Ww, Ww^Bw|, Ww, Ds, Ww, Ss, Ss, Gg, Ds, Gg, Gg, Re, Gg, Gg, Gg^Ve, Gg, Ds, Gg, Ww, Ww
Ds, Ds, Ds, Gg, Gg, Gs^Fp, Gg, Gg, Gg, Gg, Gg, Ss, Ss, Ss, Ds, Gg^Ve, Gg, Ss, Ww, Ww, Ww, Ww, Ww, Ww^Bw|, Ww, Ww^Bw|, Ww, Ww, Ww, Ww, Ww, Hh, Hh, Mm, Gg, Re, Gg, Ds, Ww, Ww, Ww, Ww, Wo, Wo
Ww, Ww, Ww, Ds, Ds, Gg, Gg^Vh, Gg, Gg, Rr, Gg, Gg^Vh, Gg, Ss, Ss, Ds, Ww, Ww, Wo, Wo, Wo, Wo, Ww, Ww^Bw|, Wo, Ww^Bw|, Wo, Ww, Ww, Ww, Ww, Ww, Ww^Bw/, Ch, Hh, Re, Hh, Ds, Ww, Ww, Wo, Ww, Wo, Wo
Ww, Ww, Ww, Ds, Ds, Gg, Gg, Gg, Rr, Rr, Gg, Gg, Ds, Ss, Ww, Ww, Wo, Wo, Wo, Wo, Ww, Ww, Hh, Ww^Bw|, Ww, Ww^Bw|, Ww, Wo, Wo, Ww, Ww^Bw/, Ww^Bw/, Wo, Ww, Ww^Bw/, Ch, Wo, Ww, Wo, Wo, Wo, Wo, Wo, Wo
Ww, Ww, Wo, Ww, Ww, Ds, Ce, Ce, Ce, Rr, Gg^Vh, Gg, Ww, Ww, Wo, Wo, Wo, Wo, Ww, Ww, Hh, Hh, Mm, Ww^Bw|, Mm, Ww^Bw|, Hh, Ww, Ww^Bw/, Ww^Bw/, Ww, Wo, Ww^Bw/, Ww^Bw/, Wo, Wo, Wo, Wo, Wo, Wo, Wo, Wo, Wo, Wo
Wo, Wo, Wo, Wo, Ww, Ww^Bw/, Ce, Ke, Ce, Gg, Hh, Ww, Ww, Wo, Wo, Wo, Ww, Ww, Ww, Ww, Mm, Mm, Gg, Ch, Mm, Ch, Ch, Ww^Bw/, Hh, Ww, Ww^Bw/, Ww^Bw/, Ww, Wo, Ww, Wo, Wo, Wo, Wo, Wo, Wo, Wo, Wo, Wo
Wo, Wo, Wo, Wo, Wo, Ww, Ww, Gg^Vh, Ds, Ds, Ww, Ww, Wo, Wo, Wo, Ww, Ww, Ww, Hh, Hh, Rr, Gg, Gg^Vh, Gg, Gg, Gg, Rr, Mm, Ch, Ww^Bw/, Hh, Ww, Ww, Ww, Ww, Wo, Wo, Wo, Wo, Wo, Wo, Wo, Ww, Ww
Wo, Wo, Wo, Wo, Wo, Ww, Ww, Ww^Bw|, Ww, Ww, Ww, Ww, Wo, Wo, Ww, Ww, Ww, Hh, Mm, Gg^Vh, Rr, Gg, Rr, Rr, Rr, Rr, Gg^Vh, Rr, Gg, Mm, Hh, Hh, Hh, Hh, Hh, Ww, Ww, Wo, Wo, Wo, Wo, Wo, Ww, Ww
Wo, Wo, Wo, Wo, Wo, Wo, Wo, Wo, Wo, Ww, Wo, Wo, Wo, Wo, Ww, Ww, Ww, Hh, Mm, Gg, Gg, Rr, Gg, Gg, Gg, Gg, Gg, Rr, Rr, Mm, Mm, Mm, Mm, Mm, Mm, Hh, Hh, Ww, Wo, Wo, Wo, Ww, Ds, Ds
Wo, Wo, Wo, Wo, Wo, Wo, Wo, Wo, Wo, Wo, Wo, Wo, Wo, Wo, Ww, Ww, Ww, Ww, Hh, Gg^Vh, Rr, Rr, Gg^Vh, Gg, Gg, Ch, Ch, Ch, Gg, Rr, Rr, Gg, Gg, Mm, Mm, Mm, Hh, Ww, Ww, Wo, Wo, Ww, Ds, Ds
Wo, Wo, Wo, Wo, Wo, Wo, Wo, Wo, Wo, Wo, Wo, Wo, Wo, Wo, Ww, Ww, Ds, Ww, Ww, Rr, Rr, Gg, Gg, Gg, Ch, Ch, 2 Kh, Ch, Ch, Gg, Gg^Vh, Rr, Rr, Gg, Gg, Mm, Hh, Ww, Ww, Wo, Wo, Ww, Ds, Ds
Wo, Wo, Wo, Wo, Wo, Wo, Wo, Wo, Wo, Wo, Wo, Wo, Wo, Wo, Ww^Bw\, Gg, Gg, Ds, Ww, Wwf, Ww, Rr, Ch, Gg, Gg, Ch, Ch, Ch, Gg, Gg, Gg, Gg, Rr, Gg^Vh, Gg, Mm, Mm, Hh, Ww, Wo, Wo, Ww, Hh, Hh
Wo, Wo, Wo, Wo, Wo, Wo, Wo, Wo, Wo, Wo, Wo, Wo, Wo, Wo, Hh, Gg^Vh, Gg, Gg, Gg, Gg, Wwf, Wwf, Ww^Bw/, Rr, Rr, Ch, Gg, Ch, Gg, Gg, Gg, Gg, Rr, Gg, Gg, Mm, Hh, Hh, Ww, Wo, Wo, Ww, Hh, Hh
Wo, Wo, Wo, Wo, Wo, Wo, Wo, Wo, Wo, Wo, Wo, Wo, Wo, Ds, Hh, Rr, Rr, Rr, Rr, Gg, Rr, Ww^Bw/, Ww, Ch, Rr, Gg, Gg, Gg, Gg, Gg^Vh, Gg, Rr, Gg^Vh, Rr, Rr, Rr, Ch, Ww, Ww, Ww, Ww, Ww, Ds, Ds
Wo, Wo, Wo, Wo, Wo, Wo, Wo, Wo, Wo, Wo, Wo, Wo, Wo, Ds, Ce, Ce, Ce, Gg, Rr, Rr, Gg, Gg, Gg, Wwf, Gg, Rr, Rr, Rr, Rr, Rr, Rr, Rr, Gg, Gg, Rr, Mm, Hh, Ww^Bw\, Ww^Bw\, Ww, Ww, Ww, Gg, Gg
Wo, Wo, Wo, Wo, Wo, Wo, Wo, Wo, Wo, Wo, Wo, Wo, Wo, Ds, Gg^Vh, Ke, Ce, Rr, Gg, Gg, Gg, Gg, Hh, Wwf, Ww^Bw/, Gg^Vh, Gg, Gg, Rr, Gg^Vh, Rr, Gg, Gg, Gg, Mm, Ch, Ww^Bw\, Ww, Wo, Ww^Bw\, Ww^Bw\, Hh, Gg, Gg
Wo, Wo, Wo, Wo, Wo, Wo, Wo, Wo, Wo, Wo, Wo, 1 Wo^Bsd, Wo, Ww^Bw/, Ds, Ce, Gg, Rr, Gg, Gg, Gg^Vh, Hh, Ww, Ww, Ww, Ds, Gg, Gg, Rr, Gg, Rr, Gg, Mm, Mm, Mm, Hh, Ww, Ww^Bw\, Ww^Bw\, Wo, Ww, Ch, Re, Re
Wo, Wo, Wo, Wo, Wo, Wo, Wo, Wo, Wo, Wo, Wo, Wo, Wo, Wo, Wo, Hh, Gg^Vh, Rr, Gg^Vh, Ds, Ww, Ww^Bw\, Ww, Ww, Ww, Ww^Bw/, Ww, Mm, Ch, Mm, Ch, Mm, Hh, Mm, Hh, Hh, Ww, Ww, Wo, Ww^Bw\, Ww^Bw\, Hh, Re, Re
Wo, Wo, Wo, Wo, Wo, Wo, Wo, Wo, Wo, Wo, Wo, Wo, Wo, Wo, Wo, Ww^Bw/, Wo, Ds, Ww^Bw|, Ww, Ww, Ww, Ww, Ww, Ww, Ww, Ww, Hh, Ww^Bw|, Hh, Ww^Bw|, Hh, Ww, Hh, Ww, Ww, Wo, Wo, Ww, Ww, Hh, Ch, Gg, Gg
Wo, Wo, Wo, Wo, Wo, Wo, Wo, Wo, Wo, Wo, Wo, Wo, Wo, Wo, Wo, Wo, Wo, Wo, Wo, Ww, Wo, Ww, Wo, Wo, Wo, Ww, Ww, Ww, Ww^Bw|, Ww, Ww^Bw|, Ww, Wo, Ww, Wo, Wo, Ww, Ww, Ds, Ds, Gg, Gg, Gg, Gg
Wo, Wo, Wo, Wo, Wo, Wo, Wo, Wo, Wo, Wo, Wo, Wo, Wo, Wo, Wo, Wo, Ww, Wo, Ww, Wo, Wo, Wo, Wo, Wo, Wo, Wo, Wo, Ww, Ww^Bw|, Ww, Ww^Bw|, Ww, Ww, Ww, Ww, Ww, Ww, Ww, Ds, Ds, Gg, Gg, Gg, Gg
Wo, Wo, Wo, Wo, Wo, Wo, Wo, Wo, Wo, Wo, Wo, Wo, Wo, Wo, Ww, Ww, Ww, Ww, Ds, Ww, Ww, Wo, Ww, Wo, Ww, Ww, Ww, Ww, Ww^Bw|, Ww, Ww^Bw|, Ww, Ww, Ww, Gg, Ww, Ds, Ds, Gg, Gg, Gg, Gs^Fp, Gg, Gg
Wo, Wo, Wo, Wo, Wo, Wo, Wo, Wo, Wo, Wo, Wo, Wo, Wo, Wo, Ww, Ww, Ds, Ds, Gg, Ds, Gg, Ww, Ww, Ww, Ds, Ww, Ds, Hh, Ch, Hh, Ch, Hh, Ds, Gg, Gg, Gg, Gg, Gg, Gg, Gg, Gs^Fp, Gs^Fp, Gs^Fp, Gs^Fp
Wo, Wo, Wo, Wo, Wo, Wo, Wo, Wo, Wo, Wo, Wo, Wo, Wo, Wo, Ww, Ww^Bw\, Gg^Vh, Ce, Ce, Gg, Gg, Gg, Gg, Ds, Ds, Ds, Gg, Gg^Vh, Re, Re, Re, Gg, Gg^Vh, Gg, Gg, Gg, Gg, Gg, Gg, Gg, Gs^Fp, Gs^Fp, Gs^Fp, Gs^Fp
Wo, Wo, Wo, Wo, Wo, Wo, Wo, Wo, Wo, Wo, Wo, Wo, Wo, Wo, Ww, Ww, Ce, Ke, Ce, Gg, Gg, Gg, Gg, Gg, Gg, Gg, Gg, Gg, Gg, Re, Gg, Gg, Gg, Gg, Gg, Gg, Gg, Gg, Gg, Gg^Vh, Gg, Gs^Fp, Gg, Gg
Wo, Wo, Wo, Wo, Wo, Wo, Wo, Wo, Wo, Wo, Wo, Wo, Wo, Wo, Wo, Ww^Bw\, Gg^Vh, Ce, Gg, Gg, Gg, Gg, Gg, Gg, Gg, Gg, Gg, Gg, Gg, Re, Ce, Ce, Ce, Gg, Gg, Gg, Gg, Gg, Gg, Gg, Gg, Gg, Gg, Gg
Wo, Wo, Wo, Wo, Wo, Wo, Wo, Wo, Wo, Wo, Wo, Wo, Wo, Wo, Wo, Ww, Ww, Ds, Gg, Gg, Gg, Gg, Gg^Vh, Gg, Gs^Fp, Gg, Gg, Gg, Re, Re, Ce, 3 Ke, Ce, Gg, Gg, Gg, Gg, Gg, Gg, Gg, Gg, Gg, Re, Re
Wo, Wo, Wo, Wo, Wo, Wo, Wo, Wo, Wo, Wo, Wo, Wo, Wo, Wo, Wo, Ww, Ww^Bw\, Hh, Gg, Gg, Gg, Gg, Gs^Fp, Gs^Fp, Gs^Fp, Gg, Re, Re, Gg, Gg, Gg, Ce, Gg, Gg, Gg, Gg, Gs^Fp, Gg, Gs^Fp, Gg, Gg, Re, Gg, Gg
Wo, Wo, Wo, Wo, Wo, Wo, Wo, Wo, Wo, Wo, Wo, Wo, Wo, Wo, Wo, Ww, Ds, Gg^Vh, Gg, Gg, Gg, Gs^Fp, Gg, Gs^Fp, Gg, Gg, Re, Gg, Gg, Gg^Vh, Gg, Gg, Gs^Fp, Gs^Fp, Gs^Fp, Gs^Fp, Gs^Fp, Gs^Fp, Gs^Fp, Gs^Fp, Re, Re, Gg, Gg
Wo, Wo, Wo, Wo, Wo, Wo, Wo, Wo, Wo, Wo, Wo, Wo, Wo, Wo, Wo, Ww, Ds, Gg, Gg, Gg, Gg, Gs^Fp, Gg, Gs^Fp, Gg, Gg, Re, Gg, Gg, Gg, Gg, Gg, Gs^Fp, Gs^Fp, Gs^Fp, Gs^Fp, Gs^Fp, Gs^Fp, Gs^Fp, Gs^Fp, Re, Re, Gg, Gg
