border_size=1
usage=map

Wo, Wo, Wo, Wo, Wo, Wo, Wo, Wo, Wo, Wo, Wo, Wo, Wo, Wo, Wo, Wo, Wo, Wo, Wo, Wo, Wo, Wo, Wo, Wo, Wo, Wo
Wo, Wo, Wo, Wo, Wo, Wo, Wo, Wo, Wo, Wo, Wo, Wo, Wo, Wo, Wo, Wo, Wo, Wo, Wo, Wo, Wo, Wo, Wo, Wo, Wo, Wo
Wo, Wo, Wo, Wo, Wo, Wo, Wo, Wo, Wo, Wo, Wo, Wo, Wo, Wo, Wo, Wo, Wo, Wo, Wo, Wo, Wo, Wo, Wo, Wo, Wo, Wo
Wo, Wo, Wo, Wo, Wo, Wo, Wo, Wo, Wo, Wo, Wo, Wo, Wo, Wo, Wo, Wo, Wo, Wo, Wo, Wo, Wo, Wo, Wo, Wo, Wo, Wo
Wo, Wo, Wo, Wo, Wo, Wo, Wo, Wo, Wo, Wo, Wo, Wo, Wo, Wo, Wo, Wo, Re, Xuce, Xuce, Wo, Wo, Wo, Wo, Wo, Wo, Wo
Wo, Wo, Wo, Wo, Wo, Wo, Wo, Wo, Wo, Wo, Wo, Wo, Wo, Wo, Rd, Rd, Ce, Re, Re, Xuce, Wo, Wo, Wo, Wo, Wo, Wo
Wo, Wo, Wo, Wo, Wo, Wo, Wo, Wo, Wo, Wo, Wo, Wo, Rd, Rd, Re, Ce, 1 Ke, Ce, Re, Xuce, Wo, Wo, Wo, Wo, Wo, Wo
Wo, Wo, Wo, Wo, Wo, Wo, Wo, Wo, Wo, Wo, Rd, Rd, Re, Re, Re, Ce, Ce, Ce, Re, Xuce, Wo, Wo, Wo, Wo, Wo, Wo
Wo, Wo, Wo, Wo, Wo, Wo, Wo, Wo, Rd, Rd, Re, Re, Xuce, Re, Re, Re, Rd^Wyb, Rd, Wo, Wo, Wo, Wo, Wo, Wo, Wo, Wo
Wo, Wo, Wo, Wo, Wo, Wo, Xuce, Rd, Re, Re, Re, Re, Re, Re, Rd^Wyb, Rd, Wo^Bh|, Wo, Wo, Wo, Wo, Wo, Wo, Wo, Wo, Wo
Wo, Wo, Wo, Wo, Wo, Wo, Xuce, Re, Re, Xuce, Re, Re, Rd, Rd, Wo^Bh|, Wo, Wo^Bh|, Wo, Wo, Wo, Wo, Wo, Wo, Wo, Wo, Wo
Wo, Wo, Wo, Wo, Wo, Wo, Xuce, Re, Re, Re, Rd, Rd, Wo, Wo, Wo^Bh|, Wo, Wo^Bh|, Wo, Wo, Wo, Wo, Wo, Wo, Wo, Wo, Wo
Wo, Wo, Wo, Wo, Wo, Wo, Wo, Xuce, Xuce, Rd, Wo, Wo, Xuce, Wo, Wo^Bh|, Wo, Wo^Bh|, Wo, Wo, Wo, Wo, Wo, Wo, Wo, Wo, Wo
Wo, Wo, Wo, Wo, Wo, Wo, Wo, Wo, Wo, Wo, Xuce, Xuce, Re, Rd, Rd^Wyb, Wo, Wo^Bh|, Wo, Wo, Wo, Wo, Wo, Wo, Wo, Wo, Wo
Wo, Wo, Wo, Wo, Xuce, Wo, Wo, Wo, Wo, Wo, Xuce, Re, Re, Re, Re, Rd, Rd^Wyb, Wo, Wo, Wo, Wo, Wo, Wo, Wo, Wo, Wo
Wo, Wo, Xuce, Xuce, Re, Xuce, Xuce, Wo, Wo, Wo, Xuce, Re, Re, Xuce, Re, Re, Re, Rd, Rd, Wo, Wo, Wo, Wo, Wo, Wo, Wo
Wo, Wo, Rd, Re, Re, Re, Rd, Wo, Wo, Wo, Wo^Bh/, Rd^Wyb, Rd, Re, Re, Re, Xuce, Re, Re, Rd, Rd, Wo, Wo, Wo, Wo, Wo
Wo, Wo, Rd, Re, Xuce, Re, Rd, Wo, Wo^Bh/, Wo^Bh/, Wo, Wo, Wo^Bh/, Rd^Wyb, Rd, Re, Re, Re, Ce, Ce, Ce, Re, Xuce, Wo, Wo, Wo
Wo, Wo, Rd, Re, Re, Re, Rd^Wyb, Wo^Bh/, Wo, Wo, Wo^Bh/, Wo^Bh/, Wo, Wo, Wo, Rd, Rd, Re, Ce, 3 Ke, Ce, Re, Xuce, Wo, Wo, Wo
Wo, Wo, Rd, Re, Ce, Re, Rd, Wo, Wo^Bh/, Wo^Bh/, Wo, Wo, Wo, Wo, Wo, Wo, Wo, Rd, Rd, Ce, Re, Urb^Wyb, Xuce, Wo, Wo, Wo
Wo, Wo, Rd, Ce, 2 Ke, Ce, Rd^Wyb, Wo^Bh/, Wo, Wo, Wo, Wo, Wo, Wo, Wo, Wo, Wo, Wo, Wo, Re, Xuce, Xuce, Wo, Wo, Wo, Wo
Wo, Wo, Re, Ce, Ce, Ce, Re, Wo, Wo, Wo, Wo, Wo, Wo, Wo, Wo, Wo, Wo, Wo, Wo, Wo, Wo, Wo, Wo, Wo, Wo, Wo
Wo, Wo, Xuce, Re, Re, Re, Xuce, Wo, Wo, Wo, Wo, Wo, Wo, Wo, Wo, Wo, Wo, Wo, Wo, Wo, Wo, Wo, Wo, Wo, Wo, Wo
Wo, Wo, Wo, Xuce, Xuce, Xuce, Wo, Wo, Wo, Wo, Wo, Wo, Wo, Wo, Wo, Wo, Wo, Wo, Wo, Wo, Wo, Wo, Wo, Wo, Wo, Wo
Wo, Wo, Wo, Wo, Wo, Wo, Wo, Wo, Wo, Wo, Wo, Wo, Wo, Wo, Wo, Wo, Wo, Wo, Wo, Wo, Wo, Wo, Wo, Wo, Wo, Wo
Wo, Wo, Wo, Wo, Wo, Wo, Wo, Wo, Wo, Wo, Wo, Wo, Wo, Wo, Wo, Wo, Wo, Wo, Wo, Wo, Wo, Wo, Wo, Wo, Wo, Wo
Wo, Wo, Wo, Wo, Wo, Wo, Wo, Wo, Wo, Wo, Wo, Wo, Wo, Wo, Wo, Wo, Wo, Wo, Wo, Wo, Wo, Wo, Wo, Wo, Wo, Wo
