border_size=1
usage=map

Ce, Ce, Ce, Ce, Rb, Xol, Xol, Xol, Xol, Xol, Cud, Xol, Xol, Xol, Xol, Xol, Xol, Xol, Xol, Xol, Xol, Xol
Ce, Ce, 1 Ke, Ce, Gg, Xol, Xol, Xol, Xol, Xol, Cud, Xol, Xol, Xol, Xol, Xol, Xol, Xol, Xol, Xol, Xol, Xol
Ce, Ce, Ce, Ce, Gg, Xol, Xol, Xol, Xol, 2 Kud, Cud, Rd, Rd, Xol, Xol, Xol, Xol, Xol, Xol, Xol, Xol, Xol
Gg, Rb^Vct, Rrc, Rrc, Gg, Xol, Xol, Xol, Xol, Xol, Xol, Gg, Rd, Gg, Gg, Xol, Xol, Xol, Xol, Xol, Xol, Xol
Gg, Rb, Rrc, Rrc, Gg, Gg, Gg, Xol, Gg, Xol, Gg, Xol, Gg, Rd, Gg, Xol, Xol, Xol, Xol, Xol, Xol, Xol
Gg, Gg, Rrc, Rrc, Rrc, Gg^Fet, Rrc, Gg, Rrc, Gg, Rrc, Gg, Rrc, Rd, Gg, Xol, Xol, Xol, Xol, Xol, Xol, Xol
Gg, Gg, Rd, Rrc, Rrc, Rrc, Rrc, Rrc, Rrc, Rrc, Rrc, Rrc, Rrc, Rrc, Rrc, Gg, Gg, Xol, Xol, Xol, Xol, Xol
Rd, Rd, Gg, Gg, Gg, Rrc, Gg, Rrc, Gg, Rrc, Gg, Rrc, Gg, Rrc, Rrc, Rrc, Rrc, Gg, Gg, Xol, Gg, Gg
Gg, Rd, Gg, Xol, Xol, Gg, Xol, Gg, Xol, Gg, Xol, Gg, Xol, Gg, Gg, Rrc, Rrc, Rrc, Rrc, Gg, Rrc, Rrc
Gg, Rd, Gg, Xol, Cud, Xol, Xol, Xol, Xol, Xol, Xol, Xol, Xol, Xol, Xol, Gg, Gg, Rrc, Rrc, Rrc, Rrc, Rrc
Gg, Rd, Rd, Cud, 3 Kud, Cud, Rd, Gg, Gg, Xol, Xol, Xol, Xol, Xol, Xol, Xol, Xol, Gg, Rrc, Rrc, Rrc, Rrc
Xol, Xol, Xol, Cud, Xol, Cud, Xol, Rd, Gg, Xol, Xol, Xol, Xol, Xol, Xol, Xol, Xol, Gg, Rrc, Rrc, Rrc, Rrc
Xol, Xol, Gg, Xol, Xol, Xol, Xol, Rd, Rd, Gg, Gg, Xol, Gg, Xol, Gg, Xol, Gg, Gg, Rrc, Rrc, Rrc, Rrc
Re^Gvs, Re^Gvs, Gg, Gg, Gg, Gg, Gg, Gg, Rrc, Gg, Rrc, Gg, Rrc, Gg, Rrc, Gg, Rrc, Rrc, Rrc, Rrc, Rrc, Rrc
Re^Gvs, Re^Gvs, Rrc, Gg^Fet, Rrc, Rrc, Rrc, Rrc, Rrc, Rrc, Rrc, Rrc, Rrc, Rrc, Rrc, Rrc, Rrc, Rrc, Gg, Gg, Gg, Gg
Rrc, Rrc, Rrc, Rrc, Ce, Ce, Ce, Rrc, Gg^Fet, Rrc, Gg, Rrc, Gg, Rrc, Gg, Rrc, Gg, Rd, Xol, Xol, Xol, Xol
Gg, Rb, Rrc^Vhc, Rrc, Ce, Ket, Ce, Rrc, Gg, Gg, Xol, Gg, Xol, Gg, Xol, Gg, Rd, Rd, Gg, Xol, Xol, Xol
Ww^Bsb/, Ww^Bsb/, Ww, Rr, Rr^Vhc, Ce, Rrc, Rrc, Gg, Xol, Xol, Xol, Xol, Xol, Gg, Gg, Rd, Gg, Xol, Xol, Xol, Xol
Ww, Ww, Ww^Bsb/, Ww^Bsb/, Ww, Rr, Rr^Vhc, Rrc, Gg, Xol, Xol, Xol, 4 Kud, Cud, Cud, Rd, Xol, Xol, Xol, Xol, Xol, Xol
Ww, Ww, Ww, Ww, Ww^Bsb/, Ww^Bsb/, Ww, Rb, Gg, Xol, Xol, Xol, Xol, Cud, Xol, Xol, Xol, Xol, Xol, Xol, Xol, Xol
Wo, Ww, Ww, Ww, Ww, Ww, Ww, Gg, Gg, Gg, Hd^Dr, Xol, Xol, Xol, Xol, Xol, Xol, Xol, Xol, Xol, Xol, Xol
Wo, Wo, Ww, Ww, Ww, Ww, Ww, Rb, Gg, Gg, Gg, Xol, Xol, Xol, Xol, Xol, Xol, Xol, Xol, Xol, Xol, Xol
