border_size=1
usage=map

Ce          , Ce          , Ce          , Ce          , Gg          , Xu          , Xu          , Xu          , Xu          , Xu          , Cud         , Xu          , Xu          , Xu          , Xu          , Xu          , Xu          , Xu          , Xu          , Xu          , Xu          , Xu          
Ce          , Ce          , 1 Ke        , Ce          , Gg          , Xu          , Xu          , Xu          , Xu          , Xu          , Cud         , Xu          , Xu          , Xu          , Xu          , Xu          , Xu          , Xu          , Xu          , Xu          , Xu          , Xu          
Ce          , Ce          , Ce          , Ce          , Gg          , Xu          , Xu          , Xu          , Xu          , 2 Kud       , Cud         , Re          , Re          , Xu          , Xu          , Xu          , Xu          , Xu          , Xu          , Xu          , Xu          , Xu          
Gg          , Re^Vct      , Rr          , Rr          , Gg          , Xu          , Xu          , Xu          , Xu          , Xu          , Xu          , Gg          , Re          , Gg          , Gg          , Xu          , Xu          , Xu          , Xu          , Xu          , Xu          , Xu          
Gg          , Gg          , Rr          , Rr          , Gg          , Gg          , Gg          , Xu          , Gg          , Xu          , Gg          , Xu          , Gg          , Re          , Gg          , Xu          , Xu          , Xu          , Xu          , Xu          , Xu          , Xu          
Gg          , Gg          , Rr          , Rr          , Rr          , Gg^Fet      , Rr          , Gg          , Rr          , Gg          , Rr          , Gg          , Rr          , Re          , Gg          , Xu          , Xu          , Xu          , Xu          , Xu          , Xu          , Xu          
Gg          , Gg          , Re          , Rr          , Rr          , Rr          , Rr          , Rr          , Rr          , Rr          , Rr          , Rr          , Rr          , Rr          , Rr          , Gg          , Gg          , Xu          , Xu          , Xu          , Xu          , Xu          
Re          , Re          , Gg          , Gg          , Gg          , Rr          , Gg          , Rr          , Gg          , Rr          , Gg          , Rr          , Gg          , Rr          , Rr          , Rr          , Rr          , Gg          , Gg          , Xu          , Gg          , Gg          
Gg          , Re          , Gg          , Xu          , Xu          , Gg          , Xu          , Gg          , Xu          , Gg          , Xu          , Gg          , Xu          , Gg          , Gg          , Rr          , Rr          , Rr          , Rr          , Gg          , Rr          , Rr          
Gg          , Re          , Gg          , Xu          , Cud         , Xu          , Xu          , Xu          , Xu          , Xu          , Xu          , Xu          , Xu          , Xu          , Xu          , Gg          , Gg          , Rr          , Rr          , Rr          , Rr          , Rr          
Gg          , Re          , Re          , Cud         , 3 Kud       , Cud         , Re          , Gg          , Gg          , Xu          , Xu          , Xu          , Xu          , Xu          , Xu          , Xu          , Xu          , Gg          , Rr          , Rr          , Rr          , Rr          
Xu          , Xu          , Xu          , Cud         , Xu          , Cud         , Xu          , Re          , Gg          , Xu          , Xu          , Xu          , Xu          , Xu          , Xu          , Xu          , Xu          , Gg          , Rr          , Rr          , Rr          , Rr          
Xu          , Xu          , Gg          , Xu          , Gg          , Xu          , Xu          , Re          , Re          , Gg          , Gg          , Xu          , Gg          , Xu          , Gg          , Xu          , Gg          , Gg          , Rr          , Rr          , Rr          , Rr          
Re^Gvs      , Re^Gvs      , Gg          , Gg          , Gg          , Gg          , Gg          , Gg          , Rr          , Gg          , Rr          , Gg          , Rr          , Gg          , Rr          , Gg          , Rr          , Rr          , Rr          , Rr          , Rr          , Rr          
Re^Gvs      , Re^Gvs      , Rr          , Gg^Fet      , Rr          , Rr          , Rr          , Rr          , Rr          , Rr          , Rr          , Rr          , Rr          , Rr          , Rr          , Rr          , Rr          , Rr          , Gg          , Gg          , Gg          , Gg          
Rr          , Rr          , Rr          , Rr          , Ce          , Ce          , Ce          , Rr          , Gg^Fet      , Rr          , Gg          , Rr          , Gg          , Rr          , Gg          , Rr          , Gg          , Re          , Xu          , Xu          , Xu          , Xu          
Gg          , Gg          , Gg^Vh       , Rr          , Ce          , Ke          , Ce          , Rr          , Gg          , Gg          , Xu          , Gg          , Xu          , Gg          , Xu          , Gg          , Re          , Re          , Gg          , Xu          , Xu          , Xu          
Ww^Bw/      , Ww^Bw/      , Ww          , Gg          , Gg^Vh       , Ce          , Rr          , Rr          , Gg          , Xu          , Xu          , Xu          , Xu          , Xu          , Gg          , Gg          , Re          , Gg          , Xu          , Xu          , Xu          , Xu          
Ww          , Ww          , Ww^Bw/      , Ww^Bw/      , Ww          , Gg          , Gg^Vh       , Rr          , Gg          , Xu          , Xu          , Xu          , 4 Kud       , Cud         , Cud         , Re          , Xu          , Xu          , Xu          , Xu          , Xu          , Xu          
Ww          , Ww          , Ww          , Ww          , Ww^Bw/      , Ww^Bw/      , Ww          , Gg          , Gg          , Xu          , Xu          , Xu          , Xu          , Cud         , Xu          , Xu          , Xu          , Xu          , Xu          , Xu          , Xu          , Xu          
Wo          , Ww          , Ww          , Ww          , Ww          , Ww          , Ww          , Gg          , Gg          , Gg          , Hd^Dr       , Xu          , Xu          , Xu          , Xu          , Xu          , Xu          , Xu          , Xu          , Xu          , Xu          , Xu          
Wo          , Wo          , Ww          , Ww          , Ww          , Ww          , Ww          , Gg          , Gg          , Gg          , Gg          , Xu          , Xu          , Xu          , Xu          , Xu          , Xu          , Xu          , Xu          , Xu          , Xu          , Xu          
