Gg, Gg, Rr, Gg, Gg, Gg, Rd, Rd, Gg, Rd, Rr, Rr, Gs^Fds, Gg, Gg, Gs^Fds, Gg, Rd, Rd, Gg, Rr, Rr
Gg, Gg, Rr, Gg, Gg^Vdt, Gg, Rd, Rd, Gg, Rd, Rr, Rr, Gs^Fds, Gg, Gg, Gs^Fds, Gg, Rd, Rd, Gs^Vl, Rr, Rr
Rr, Rr, Gs^Vl, Rr, Rr, Rd, Gg, Gg, Ch, Gg, Rr, Rr^Vhc, Gg, Gg, Ch, Gg, Gg, Rr^Vhc, Rr, Rr, Rr^Vhc, Gg
Gg, Gg, Rd, Rd, Rr^Vhc, Rr, Gg, 1 Kh, Ch, Gg, Rr, Rr, Rr, Gg, Ch, Kh, Gg, Gs^Fds, Rr, Gg, Gs^Fds, Gs^Fds
Gs^Fds, Gs^Fds, Rd, Gg, Gg, Rr, Rr, Ch, Rr, Rr, Ch, Ch, Ch, Rr, Rr, Ch, Rr, Rr, Rd, Gg, Gg, Gg
Gg, Gg, Rd, Gs^Vl, Gs^Fds, Gg, Gg, Rr, Ch, Ch, Rr, Rr, Rr, Ch, Ch, Rr, Rr, Gs^Vl, Gg, Rd, Rr^Vhc, Gg
Gg, Gg, Rd, Gg, Gg, Gg, Ch, Rr, Ch, Rr, Urb, Urb, Urb, Rr, Ch, Rr, Ch, Gg, Gg, Rd, Rd, Rd
Rd, Rd, Rr^Vhc, Gs^Fds, Gg, Kh, Ch, Rr, Ch, Rr, Urb, 2 Kv, Urb, Rr, Ch, Rr, Ch, Kh, Gg, Rr^Vhc, Rd, Rd
Rd, Rd, Rd, Gs^Fds, Gg, Gg, Rr, Rr, Ch, Rr, Rr, Urb, Rr, Rr, Ch, Rr, Gg, Gs^Fp, Gg, Gg, Rd, Rd
Gg, Gg, Rd, Gg, Gs^Vl, Rr, Rr, Rr, Rr, Ch, Ch, Rr, Ch, Ch, Rr, Rr, Rr, Gg, Rr^Vhc, Rd, Gs, Rd
Gg, Gg, Rr, Gg, Rr, Rr, Gg, Ch, Ch, Rr, Rr, Ch, Rr, Rr, Ch, Ch, Gg, Rr, Rd, Rd, Gs^Fds, Gs^Fds
Rr, Rr, Gg, Rr, Rd, Rr^Vhc, Gg, Kh, Ch, Gg, Gs^Fds, Rr, Gg, Gs^Fds, Ch, Kh, Gg, Rr, Rr, Gg, Gs^Fds, Gs^Fds
Rd, Rd, Rr^Vhc, Gg, Gs^Fp, Rd, Rd, Gg, Gg, Gg, Rr, Rr, Gg, Gg, Gg, Gg, Rd, Rd, Rr, Gg, Rr^Vhc, Gg
Rd, Rd, Rd, Gg, Gs^Fp, Gs^Fp, Gg, Rd, Rd, Rr, Rd, Gs^Vl, Rd, Rd, Rd, Rd, Gs^Vl, Gg, Gg, Rr, Rr, Rr
Gg, Gg, Rr^Vhc, Rd, Rd, Rr^Vhc, Rd, Gs^Vl, Rr, Rr, Gg, Rd, Rr^Vhc, Gg, Gs^Fds, Gg, Gg, Gg, Rd, Rd, Rr, Rr
Gg, Gg, Gg, Gg, Gg, Rd, Gg, Rr, Rd, Gg, Rd, Gg, Gg, Gg, Gs^Fds, Gs^Fds, Rd, Rd, Rr^Vhc, Gg, Gs^Vl, Gg
Gs^Fds, Gs^Fds, Gs^Fds, Gg, Rr^Vhc, Gg, Rr, Rr, Gg, Rd, Gg, Rd, Rd, Gg, Rd, Rd, Gg, Gg, Gg, Gg, Gg, Gg
Gs^Fds, Gs^Fds, Gg, Gg, Rr, Rr, Gg, Gg, Gs^Fds, Gg, Gg, Rr^Vhc, Gg, Rd, Gg, Gg, Gs^Fds, Gg, Gg, Gs^Fds, Gs^Fds, Gs^Fds
Gg, Gg, Rr^Vhc, Gg, Rr, Gs^Vl, Gg, Gg, Gs^Fds, Gs^Fds, Gg, Gg, Gg, Gg, Gs^Fds, Gs^Fds, Gs^Fds, Gg, Rr^Vhc, Gs^Fds, Gg, Gg
Gg, Gg, Rr, Rr, Gg, Rd, Rd, Gg, Rd, Gs^Fds, Gg, Gg, Rr^Vhc, Gg, Gg, Gg, Gg, Gg, Rd, Rd, Rd, Rd
Gg, Gg, Rr, Rr, Gg, Gs^Fds, Gg, Rd, Gg^Vh, Rd, Rd, Rd, Rd, Rd, Rd, Rd, Rd, Rd, Gg, Gg^Vh, Gg, Gg
Gg, Gg, Rr, Rr, Gg, Gs^Fds, Gg, Rd, Gg, Rd, Rd, Rd, Rd, Rd, Rd, Rd, Rd, Rd, Gg, Gg, Gg, Gg
