border_size=1
usage=map

Gg, Gg, Rr, Gg, Gg, Gg, Rd, Rd, Gg, Rd, Rr, Rr, Gs^Fds, Gg, Gg, Gs^Fds, Gg, Rd, Rd, Gg, Rr, Rr
Gg, Gg, Rr, Gg, Gg^Ve, Gg, Rd, Rd, Gg, Rd, Rr, Rr, Gs^Fds, Gg, Gg, Gs^Fds, Gg, Rd, Rd, Gg^Vh, Rr, Rr
Rr, Rr, Gg^Ve, Rr, Rr, Rd, Gg, Gg, Ch, Gg, Rr, Gg^Ve, Gg, Gg, Ch, Gg, Gg, Gg^Ve, Rr, Rr, Gg^Ve, Gg
Gg, Gg, Rd, Rd, Gg^Ve, Rr, Gg, 1 Kh, Ch, Gg, Rr, Rr, Rr, Gg, Ch, Kh, Gg, Gs^Fds, Rr, Gg, Gs^Fds, Gs^Fds
Gs^Fds, Gs^Fds, Rd, Gg, Gg, Rr, Rr, Ch, Rr, Rr, Ch, Ch, Ch, Rr, Rr, Ch, Rr, Rr, Rd, Gg, Gg, Gg
Gg, Gg, Rd, Gg^Vh, Gs^Fds, Gg, Gg, Rr, Ch, Ch, Rr, Rr, Rr, Ch, Ch, Rr, Rr, Gg^Vh, Gg, Rd, Gg^Ve, Gg
Gg, Gg, Rd, Gg, Gg, Gg, Ch, Rr, Ch, Rr, Ch, Ch, Ch, Rr, Ch, Rr, Ch, Gg, Gg, Rd, Rd, Rd
Rd, Rd, Gg^Ve, Gs^Fds, Gg, Kh, Ch, Rr, Ch, Rr, Ch, 2 Kh, Ch, Rr, Ch, Rr, Ch, Kh, Gg, Gg^Ve, Rd, Rd
Rd, Rd, Rd, Gs^Fds, Gg, Gg, Rr, Rr, Ch, Rr, Rr, Ch, Rr, Rr, Ch, Rr, Gg, Gs^Fp, Gg, Gg, Rd, Rd
Gg, Gg, Rd, Gg, Gg^Vh, Rr, Rr, Rr, Rr, Ch, Ch, Rr, Ch, Ch, Rr, Rr, Rr, Gg, Gg^Ve, Hh^Vhh, Rd, Rd
Gg, Gg, Rr, Gg, Rr, Rr, Gg, Ch, Ch, Rr, Rr, Ch, Rr, Rr, Ch, Ch, Gg, Rr, Rd, Rd, Gs^Fds, Gs^Fds
Rr, Rr, Gg, Rr, Rd, Gg^Ve, Gg, Kh, Ch, Gg, Gs^Fds, Rr, Gg, Gs^Fds, Ch, Kh, Gg, Rr, Rr, Gg, Gs^Fds, Gs^Fds
Rd, Rd, Gg^Ve, Gg, Gs^Fp, Rd, Rd, Gg, Gg, Gg, Rr, Rr, Gg, Gg, Gg, Gg, Rd, Rd, Rr, Gg, Gg^Ve, Gg
Rd, Rd, Rd, Gg, Gs^Fp, Gs^Fp, Gg, Rd, Rd, Rr, Rd, Gg^Vh, Rd, Rd, Rd, Rd, Gg^Vh, Gg, Gg, Rr, Rr, Rr
Gg, Gg, Gg^Ve, Rd, Rd, Gg^Ve, Rd, Gg^Vh, Rr, Rr, Gg, Rd, Gg^Ve, Gg, Gs^Fds, Gg, Gg, Gg, Rd, Rd, Rr, Rr
Gg, Gg, Gg, Gg, Gg, Rd, Gg, Rr, Rd, Gg, Rd, Gg, Gg, Gg, Gs^Fds, Gs^Fds, Rd, Rd, Gg^Ve, Gg, Gg^Vh, Gg
Gs^Fds, Gs^Fds, Gs^Fds, Gg, Gg^Ve, Gg, Rr, Rr, Gg, Rd, Gg, Rd, Rd, Gg, Rd, Rd, Gg, Gg, Gg, Gg, Gg, Gg
Gs^Fds, Gs^Fds, Gg, Gg, Rr, Rr, Gg, Gg, Gs^Fds, Gg, Gg, Gg^Ve, Gg, Rd, Gg, Gg, Gs^Fds, Gg, Gg, Gs^Fds, Gs^Fds, Gs^Fds
Gg, Gg, Gg^Ve, Gg, Rr, Gg^Vh, Gg, Gg, Gs^Fds, Gs^Fds, Gg, Gg, Gg, Gg, Gs^Fds, Gs^Fds, Gs^Fds, Gg, Gg^Ve, Gs^Fds, Gg, Gg
Gg, Gg, Rr, Rr, Gg, Rd, Rd, Gg, Rd, Gs^Fds, Gg, Gg, Gg^Ve, Gg, Gg, Gg, Gg, Gg, Rd, Rd, Rd, Rd
Gg, Gg, Rr, Rr, Gg, Gs^Fds, Gg, Rd, Gg^Vh, Rd, Rd, Rd, Rd, Rd, Rd, Rd, Rd, Rd, Gg, Gg^Vh, Gg, Gg
Gg, Gg, Rr, Rr, Gg, Gs^Fds, Gg, Rd, Gg, Rd, Rd, Rd, Rd, Rd, Rd, Rd, Rd, Rd, Gg, Gg, Gg, Gg
