Wo, Wo, Wo, Wo, Wo, Wo, Wo, Wo, Wo, Wo, Wo, Wo, Wo, Wo, Wo, Wo, Wo, Wo, Wo, Wo, Wo, Wo, Wo, Wo, Wo, Wo, Wo, Wo, Wo, Wo, Wo, Wo
Wo, Wo, Wo, Wo, Wo, Wo, Wo, Wo, Wo, Wo, Wo, Wo, Wo, Wo, Wo, Wo, Wo, Wo, Wo, Wo, Wo, Wo, Wo, Wo, Wo, Wo, Wo, Wo, Wo, Wo, Wo, Wo
Wo, Wo, Wo, Wo, Wo, Wo, Wo, Wo, Wo, Wo, Wo, Wo, Wo, Wo, Ww, Ww, Ww, Ww, Ww, Wo, Wo, Wo, Wo, Wo, Wo, Wo, Wo, Wo, Wo, Wo, Wo, Wo
Wo, Wo, Wo, Wo, Wo, Wo, Wo, Wo, Wo, Wo, Wo, Wo, Ww, Ww, Dd, Dd, Dd, Dd, Dd, Ww, Wo, Wo, Wo, Wo, Wo, Wo, Wo, Wo, Wo, Wo, Wo, Wo
Wo, Wo, Wo, Wo, Wo, Wo, Wo, Wo, Wo, Wo, Ww, Ww, Dd, Dd, Dd, Dd, Dd, Gg^Ve, Dd, Ww, Ww, Wo, Wo, Wo, Wo, Wo, Wo, Wo, Wo, Wo, Wo, Wo
Wo, Wo, Wo, Wo, Wo, Wo, Wo, Wo, Wo, Ww, Dd, Dd, Gg, Dd, Dd, Dd, Ce, Gg, Gg, Dd, Dd, Ww, Ww, Ww, Ww, Wo, Wo, Wo, Wo, Wo, Wo, Wo
Wo, Wo, Wo, Wo, Wo, Wo, Ww, Wo, Ww, Ww, Dd, Gg^Ve, Gg, Gg, Ce, 2 Ke, Ce, Gg, Gg, Dd, Dd, Dd, Dd, Dd, Dd, Ww, Wo, Wo, Wo, Wo, Wo, Wo
Wo, Wo, Wo, Wo, Ww, Ww, Dd, Ww, Dd, Dd, Dd, Gg, Hd, Hd, Hd, Ce, Gg, Hd, Dd, Gg, Gs^Fp, Gs^Fp, Gs^Fp, Gs^Fp, Dd, Ww, Ww, Wo, Wo, Wo, Wo, Wo
Wo, Wo, Wo, Wo, Ww, Dd, Dd, Dd, Gg, Dd, Dd, Dd, Dd, Gs, Dd, Dd, Dd, Hd, Dd, Dd, Gs^Fp, Gs^Fp, Gs^Fp, Gs^Fp, Gs^Fp, Dd, Dd, Ww, Ww, Wo, Wo, Wo
Wo, Wo, Wo, Wo, Dd, Dd, Dd, Hd, Hd, Gg, Dd, Dd, Gs^Fp, Gs^Fp, Gs^Fp, Dd, Gg, Gg, Dd, Dd, Gs^Fp, Gs^Fp, Ww, Ww, Ww, Gs^Fp, Gs^Fp, Dd, Ww, Wo, Wo, Wo
Wo, Wo, Wo, Ww, Dd, Dd, Dd, Hd, Gg, Dd, Dd, Dd, Gs^Fp, Gs^Fp, Ww, Gs^Fp, Gs^Fp, Gg^Ve, Dd, Dd, Gs^Fp, Gs^Fp, Ww, Ww, Ww, Gs^Fp, Gs^Fp, Dd, Dd, Ww, Wo, Wo
Wo, Wo, Ww, Ww, Dd, Gg, Dd, Gg, Gs^Fp, Dd, Dd, Gs^Fp, Gs^Fp, Ww, Ww, Ww, Gs^Fp, Gs^Fp, Dd, Dd, Gs^Fp, Gs^Fp, Ww, Ww, Ww, Gs^Fp, Gs^Fp, Gg^Ve, Dd, Ww, Wo, Wo
Wo, Wo, Ww, Dd, Gg^Ve, Gg, Gs^Fp, Gs^Fp, Gs^Fp, Dd, Gg, Gs^Fp, Gs^Fp, Ww, Ww, Ww, Ww, Gs^Fp, Dd, Gg, Gs^Fp, Gs^Fp, Gs^Fp, Ww, Gs^Fp, Gs^Fp, Gs^Fp, Gg, Dd, Ww, Wo, Wo
Wo, Wo, Ww, Dd, Dd, Gs^Fp, Gs^Fp, Ww, Gs^Fp, Gs^Fp, Dd, Gg^Ve, Gs^Fp, Gs^Fp, Ww, Ww, Ww, Gs^Fp, Dd, Dd, Dd, Gs^Fp, Gs^Fp, Gs^Fp, Gs^Fp, Gs^Fp, Dd, Dd, Ww, Ww, Wo, Wo
Wo, Wo, Wo, Ww, Dd, Gs^Fp, Gs^Fp, Ww, Ww, Gs^Fp, Gs^Fp, Dd, Dd, Gs^Fp, Gs^Fp, Gs^Fp, Gs^Fp, Gs^Fp, Dd, Dd, Dd, Gg, Dd, Dd, Gg, Dd, Dd, Dd, Ww, Wo, Wo, Wo
Wo, Wo, Wo, Ww, Dd, Gs^Fp, Gs^Fp, Ww, Ww, Gs^Fp, Gg, Gg, Dd, Dd, Dd, Gs^Fp, Dd, Gg, Gg, Dd, Gg, Dd, Dd, Dd, Gg, Gg, Dd, Ww, Wo, Wo, Wo, Wo
Wo, Wo, Ww, Dd, Dd, Dd, Gs^Fp, Gs^Fp, Gs^Fp, Gs^Fp, Dd, Gg, Dd, Dd, Dd, Dd, Md, Hd, Gg, Gg, Dd, Hd, Hd, Dd, Dd, Gg, Dd, Ww, Ww, Wo, Wo, Wo
Wo, Wo, Ww, Dd, Dd, Dd, Dd, Gs^Fp, Hd, Gg, Gg, Dd, Dd, Dd, Dd, Hd, Hd, Hd, Dd, Gg, Gg^Ve, Hd, Dd, Gg, Gg, Gg, Gg^Ve, Dd, Ww, Wo, Wo, Wo
Wo, Wo, Wo, Ww, Dd, Dd, Dd, Hd, Md, Hd, Dd, Dd, Dd, Dd, Dd, Dd, Ce, Ce, Ce, Gg, Gg, Dd, Dd, Dd, Gg, Dd, Dd, Dd, Ww, Wo, Wo, Wo
Wo, Wo, Wo, Ww, Dd, Dd, Dd, Hd, Hd, Gg^Ve, Gs^Fp, Gs^Fp, Gs^Fp, Gs^Fp, Gs^Fp, Dd, Dd, 1 Ke, Dd, Dd, Gg, Dd, Dd, Dd, Dd, Dd, Dd, Ww, Wo, Wo, Wo, Wo
Wo, Wo, Wo, Ww, Ww, Dd, Dd, Hd, Gg, Gs^Fp, Gs^Fp, Ww, Ww, Gs^Fp, Gs^Fp, Dd, Gg, Dd, Dd, Gg, Dd, Dd, Ww, Ww, Ww, Dd, Ww, Ww, Wo, Wo, Wo, Wo
Wo, Wo, Wo, Wo, Wo, Ww, Dd, Dd, Gg, Gg, Gs^Fp, Gs^Fp, Ww, Ww, Ww, Gs^Fp, Gg, Gg, Dd, Dd, Dd, Ww, Wo, Wo, Wo, Ww, Wo, Wo, Wo, Wo, Wo, Wo
Wo, Wo, Wo, Wo, Wo, Ww, Ww, Dd, Dd, Gg, Gg, Gs^Fp, Gs^Fp, Ww, Gs^Fp, Gs^Fp, Dd, Dd, Dd, Dd, Ww, Ww, Wo, Wo, Wo, Wo, Wo, Wo, Wo, Wo, Wo, Wo
Wo, Wo, Wo, Wo, Wo, Wo, Ww, Dd, Dd, Dd, Dd, Gg^Ve, Dd, Gs^Fp, Gs^Fp, Dd, Dd, Dd, Ww, Ww, Wo, Wo, Wo, Wo, Wo, Wo, Wo, Wo, Wo, Wo, Wo, Wo
Wo, Wo, Wo, Wo, Wo, Wo, Wo, Ww, Ww, Dd, Ww, Dd, Ww, Dd, Dd, Dd, Dd, Dd, Ww, Wo, Wo, Wo, Wo, Wo, Wo, Wo, Wo, Wo, Wo, Wo, Wo, Wo
Wo, Wo, Wo, Wo, Wo, Wo, Wo, Wo, Wo, Ww, Wo, Ww, Wo, Ww, Ww, Dd, Ww, Ww, Wo, Wo, Wo, Wo, Wo, Wo, Wo, Wo, Wo, Wo, Wo, Wo, Wo, Wo
Wo, Wo, Wo, Wo, Wo, Wo, Wo, Wo, Wo, Wo, Wo, Wo, Wo, Wo, Wo, Ww, Wo, Wo, Wo, Wo, Wo, Wo, Wo, Wo, Wo, Wo, Wo, Wo, Wo, Wo, Wo, Wo
Wo, Wo, Wo, Wo, Wo, Wo, Wo, Wo, Wo, Wo, Wo, Wo, Wo, Wo, Wo, Wo, Wo, Wo, Wo, Wo, Wo, Wo, Wo, Wo, Wo, Wo, Wo, Wo, Wo, Wo, Wo, Wo
Wo, Wo, Wo, Wo, Wo, Wo, Wo, Wo, Wo, Wo, Wo, Wo, Wo, Wo, Wo, Wo, Wo, Wo, Wo, Wo, Wo, Wo, Wo, Wo, Wo, Wo, Wo, Wo, Wo, Wo, Wo, Wo
