border_size=1
usage=map

Wo          , Wo          , Wo          , Wo          , Wo          , Wo          , Wo          , Wo          , Wo          , Wo          , Wo          , Wo          , Wo          , Wo          , Wo          , Wo          , Wo          , Wo          , Wo          , Wo          , Wo          , Wo          , Wo          , Wo          , Wo          , Wo          , Wo          , Wo          , Wo          , Wo          , Wo          , Wo          
Wo          , Wo          , Wo          , Wo          , Wo          , Wo          , Wo          , Wo          , Wo          , Wo          , Wo          , Wo          , Wo          , Wo          , Wo          , Wo          , Wo          , Wo          , Wo          , Wo          , Wo          , Wo          , Wo          , Wo          , Wo          , Wo          , Wo          , Wo          , Wo          , Wo          , Wo          , Wo          
Wo          , Wo          , Wo          , Wo          , Wo          , Wo          , Wo          , Wo          , Wo          , Wo          , Wo          , Wo          , Wo          , Wo          , Ww          , Ww          , Ww          , Ww          , Ww          , Wo          , Wo          , Wo          , Wo          , Wo          , Wo          , Wo          , Wo          , Wo          , Wo          , Wo          , Wo          , Wo          
Wo          , Wo          , Wo          , Wo          , Wo          , Wo          , Wo          , Wo          , Wo          , Wo          , Wo          , Wo          , Ww          , Ww          , Dd          , Dd          , Dd          , Dd          , Dd          , Ww          , Wo          , Wo          , Wo          , Wo          , Wo          , Wo          , Wo          , Wo          , Wo          , Wo          , Wo          , Wo          
Wo          , Wo          , Wo          , Wo          , Wo          , Wo          , Wo          , Wo          , Wo          , Wo          , Ww          , Ww          , Dd          , Dd          , Dd          , Dd          , Dd          , Dd^Vdt      , Dd          , Ww          , Ww          , Wo          , Wo          , Wo          , Wo          , Wo          , Wo          , Wo          , Wo          , Wo          , Wo          , Wo          
Wo          , Wo          , Wo          , Wo          , Wo          , Wo          , Wo          , Wo          , Wo          , Ww          , Dd          , Dd          , Gs          , Dd          , Dd          , Dd          , Ce          , Gs          , Gs          , Dd          , Dd          , Ww          , Ww          , Ww          , Ww          , Wo          , Wo          , Wo          , Wo          , Wo          , Wo          , Wo          
Wo          , Wo          , Wo          , Wo          , Wo          , Wo          , Ww          , Wo          , Ww          , Ww          , Dd          , Dd^Vdt      , Gs          , Gs          , Ce          , 2 Ke        , Ce          , Gs          , Gs          , Dd          , Dd          , Dd          , Dd          , Dd          , Dd          , Ww          , Wo          , Wo          , Wo          , Wo          , Wo          , Wo          
Wo          , Wo          , Wo          , Wo          , Ww          , Ww          , Dd          , Ww          , Dd          , Dd          , Dd          , Gs          , Hd          , Hd          , Hd          , Ce          , Gs          , Hd          , Dd          , Gs          , Gs^Fp       , Gs^Fp       , Gs^Fp       , Gs^Fp       , Dd          , Ww          , Ww          , Wo          , Wo          , Wo          , Wo          , Wo          
Wo          , Wo          , Wo          , Wo          , Ww          , Dd          , Dd          , Dd          , Gs          , Dd          , Dd          , Dd          , Dd          , Gs          , Dd          , Dd          , Dd          , Hd          , Dd          , Dd          , Gs^Fp       , Gs^Fp       , Gs^Fp       , Gs^Fp       , Gs^Fp       , Dd          , Dd          , Ww          , Ww          , Wo          , Wo          , Wo          
Wo          , Wo          , Wo          , Wo          , Dd          , Dd          , Dd          , Hd          , Hd          , Gs          , Dd          , Dd          , Gs^Fp       , Gs^Fp       , Gs^Fp       , Dd          , Gs          , Gs          , Dd          , Dd          , Gs^Fp       , Gs^Fp       , Ww          , Ww          , Ww          , Gs^Fp       , Gs^Fp       , Dd          , Ww          , Wo          , Wo          , Wo          
Wo          , Wo          , Wo          , Ww          , Dd          , Dd          , Dd          , Hd          , Gs          , Dd          , Dd          , Dd          , Gs^Fp       , Gs^Fp       , Ww          , Gs^Fp       , Gs^Fp       , Gs^Vht      , Dd          , Dd          , Gs^Fp       , Gs^Fp       , Ww          , Ww          , Ww          , Gs^Fp       , Gs^Fp       , Dd          , Dd          , Ww          , Wo          , Wo          
Wo          , Wo          , Ww          , Ww          , Dd          , Gs          , Dd          , Gs          , Gs^Fp       , Dd          , Dd          , Gs^Fp       , Gs^Fp       , Ww          , Ww          , Ww          , Gs^Fp       , Gs^Fp       , Dd          , Dd          , Gs^Fp       , Gs^Fp       , Ww          , Ww          , Ww          , Gs^Fp       , Gs^Fp       , Gs^Vht      , Dd          , Ww          , Wo          , Wo          
Wo          , Wo          , Ww          , Dd          , Dd^Vdt      , Gs          , Gs^Fp       , Gs^Fp       , Gs^Fp       , Dd          , Gs          , Gs^Fp       , Gs^Fp       , Ww          , Ww          , Ww          , Ww          , Gs^Fp       , Dd          , Gs          , Gs^Fp       , Gs^Fp       , Gs^Fp       , Ww          , Gs^Fp       , Gs^Fp       , Gs^Fp       , Gs          , Dd          , Ww          , Wo          , Wo          
Wo          , Wo          , Ww          , Dd          , Dd          , Gs^Fp       , Gs^Fp       , Ww          , Gs^Fp       , Gs^Fp       , Dd          , Dd^Vdt      , Gs^Fp       , Gs^Fp       , Ww          , Ww          , Ww          , Gs^Fp       , Dd          , Dd          , Dd          , Gs^Fp       , Gs^Fp       , Gs^Fp       , Gs^Fp       , Gs^Fp       , Dd          , Dd          , Ww          , Ww          , Wo          , Wo          
Wo          , Wo          , Wo          , Ww          , Dd          , Gs^Fp       , Gs^Fp       , Ww          , Ww          , Gs^Fp       , Gs^Fp       , Dd          , Dd          , Gs^Fp       , Gs^Fp       , Gs^Fp       , Gs^Fp       , Gs^Fp       , Dd          , Dd          , Dd          , Gg          , Dd          , Dd          , Gs          , Dd          , Dd          , Dd          , Ww          , Wo          , Wo          , Wo          
Wo          , Wo          , Wo          , Ww          , Dd          , Gs^Fp       , Gs^Fp       , Ww          , Ww          , Gs^Fp       , Gs          , Gs          , Dd          , Dd          , Dd          , Gs^Fp       , Dd          , Gs          , Gs          , Dd          , Gs          , Dd          , Dd          , Dd          , Gs          , Gs          , Dd          , Ww          , Wo          , Wo          , Wo          , Wo          
Wo          , Wo          , Ww          , Dd          , Dd          , Dd          , Gs^Fp       , Gs^Fp       , Gs^Fp       , Gs^Fp       , Dd          , Gs          , Dd          , Dd          , Dd          , Dd          , Md          , Hd          , Gs          , Gs          , Dd          , Hd          , Hd          , Dd          , Dd          , Gs          , Dd          , Ww          , Ww          , Wo          , Wo          , Wo          
Wo          , Wo          , Ww          , Dd          , Dd          , Dd          , Dd          , Gs^Fp       , Hd          , Gs          , Gs          , Dd          , Dd          , Dd          , Dd          , Hd          , Hd          , Hd          , Dd          , Gs          , Dd^Vda      , Hd          , Dd          , Gs          , Gs          , Gs          , Dd^Vda      , Dd          , Ww          , Wo          , Wo          , Wo          
Wo          , Wo          , Wo          , Ww          , Dd          , Dd          , Dd          , Hd          , Md          , Hd          , Dd          , Dd          , Dd          , Dd          , Dd          , Dd          , Ce          , Ce          , Ce          , Gs          , Gs          , Dd          , Dd          , Dd          , Gs          , Dd          , Dd          , Dd          , Ww          , Wo          , Wo          , Wo          
Wo          , Wo          , Wo          , Ww          , Dd          , Dd          , Dd          , Hd          , Hd          , Dd^Vda      , Gs^Fp       , Gs^Fp       , Gs^Fp       , Gs^Fp       , Gs^Fp       , Dd          , Dd          , 1 Ke        , Dd          , Dd          , Gs          , Dd          , Dd          , Dd          , Dd          , Dd          , Dd          , Ww          , Wo          , Wo          , Wo          , Wo          
Wo          , Wo          , Wo          , Ww          , Ww          , Dd          , Dd          , Hd          , Gs          , Gs^Fp       , Gs^Fp       , Ww          , Ww          , Gs^Fp       , Gs^Fp       , Dd          , Gs          , Dd          , Dd          , Gs          , Dd          , Dd          , Ww          , Ww          , Ww          , Dd          , Ww          , Ww          , Wo          , Wo          , Wo          , Wo          
Wo          , Wo          , Wo          , Wo          , Wo          , Ww          , Dd          , Dd          , Gs          , Gs          , Gs^Fp       , Gs^Fp       , Ww          , Ww          , Ww          , Gs^Fp       , Gs          , Gs          , Dd          , Dd          , Dd          , Ww          , Wo          , Wo          , Wo          , Ww          , Wo          , Wo          , Wo          , Wo          , Wo          , Wo          
Wo          , Wo          , Wo          , Wo          , Wo          , Ww          , Ww          , Dd          , Dd          , Gs          , Gs          , Gs^Fp       , Gs^Fp       , Ww          , Gs^Fp       , Gs^Fp       , Dd          , Dd          , Dd          , Dd          , Ww          , Ww          , Wo          , Wo          , Wo          , Wo          , Wo          , Wo          , Wo          , Wo          , Wo          , Wo          
Wo          , Wo          , Wo          , Wo          , Wo          , Wo          , Ww          , Dd          , Dd          , Dd          , Dd          , Dd^Vda      , Dd          , Gs^Fp       , Gs^Fp       , Dd          , Dd          , Dd          , Ww          , Ww          , Wo          , Wo          , Wo          , Wo          , Wo          , Wo          , Wo          , Wo          , Wo          , Wo          , Wo          , Wo          
Wo          , Wo          , Wo          , Wo          , Wo          , Wo          , Wo          , Ww          , Ww          , Dd          , Ww          , Dd          , Ww          , Dd          , Dd          , Dd          , Dd          , Dd          , Ww          , Wo          , Wo          , Wo          , Wo          , Wo          , Wo          , Wo          , Wo          , Wo          , Wo          , Wo          , Wo          , Wo          
Wo          , Wo          , Wo          , Wo          , Wo          , Wo          , Wo          , Wo          , Wo          , Ww          , Wo          , Ww          , Wo          , Ww          , Ww          , Dd          , Ww          , Ww          , Wo          , Wo          , Wo          , Wo          , Wo          , Wo          , Wo          , Wo          , Wo          , Wo          , Wo          , Wo          , Wo          , Wo          
Wo          , Wo          , Wo          , Wo          , Wo          , Wo          , Wo          , Wo          , Wo          , Wo          , Wo          , Wo          , Wo          , Wo          , Wo          , Ww          , Wo          , Wo          , Wo          , Wo          , Wo          , Wo          , Wo          , Wo          , Wo          , Wo          , Wo          , Wo          , Wo          , Wo          , Wo          , Wo          
Wo          , Wo          , Wo          , Wo          , Wo          , Wo          , Wo          , Wo          , Wo          , Wo          , Wo          , Wo          , Wo          , Wo          , Wo          , Wo          , Wo          , Wo          , Wo          , Wo          , Wo          , Wo          , Wo          , Wo          , Wo          , Wo          , Wo          , Wo          , Wo          , Wo          , Wo          , Wo          
Wo          , Wo          , Wo          , Wo          , Wo          , Wo          , Wo          , Wo          , Wo          , Wo          , Wo          , Wo          , Wo          , Wo          , Wo          , Wo          , Wo          , Wo          , Wo          , Wo          , Wo          , Wo          , Wo          , Wo          , Wo          , Wo          , Wo          , Wo          , Wo          , Wo          , Wo          , Wo          
