Wo, Wo, Wo, Wo, Wo, Wo, Wo, Wo, Wo, Wo, Wo, Wo, Wo, Wo, Wo, Wo, Wo, Wo, Wo, Wo, Wo, Wo, Wo
Wo, Wo, Wo, Wo, Wo, Wo, Wo, Wo, Wo, Wo, Wo, Wo, Wo, Wo, Wo, Wo, Wo, Wo, Wo, Wo, Wo, Wo, Wo
Wo, Wo, Wo, Wo, Wo, Wo, Wo, Wo, Wo, Wo, Wo, Wo, Wo, Wo, Wo, Wo, Wo, Wo, Wo, Wo, Wo, Wo, Wo
Wo, Wo, Wo, Wo, Wo, Wo, Wo, Wo, Wo, Wo, Wo, Wo, Wo, Wo, Wo, Wo, Wo, Wo, Wo, Wo, Wo, Wo, Wo
Wo, Wo, Wo, Wo, Wo, Wo, Wo, Wo, Xom, Xom, Xom, Wo, Wo, Wo, Wo, Wo, Wo, Wo, Wo, Wo, Wo, Wo, Wo
Wo, Wo, Wo, Wo, Wo, Wo, Xom, Xom, Icn, Icn^Vyb, Icn, Xom, Xom, Wo, Wo, Wo, Wo, Wo, Wo, Wo, Wo, Wo, Wo
Wo, Wo, Wo, Wo, Wo, Wo, Xom, Icn^Vyb, Ce, Ce, Ce, Icn^Vyb, Xom, Wo, Wo, Wo, Xom, Xom, Xom, Wo, Wo, Wo, Wo
Wo, Wo, Wo, Wo, Wo, Wo, Xom, Icn, Ce, 2 Ke, Ce, Icn, Xom, Wo, Wo, Xom, Ior, Ior, Ior, Xom, Wo, Wo, Wo
Wo, Wo, Wo, Wo, Wo, Wo, Xom, Icn^Vyb, Ior, Ce, Ior, Icn^Vyb, Xom, Wo, Wo, Rr, Ior, Ior, Ior, Rr, Wo, Wo, Wo
Wo, Wo, Wo, Wo, Wo, Wo, Wo, Xom, Ior, Ior, Ior, Xom, Wo, Wo, Wo, Rr^Vyb, Ior, Xom, Ior, Rr^Vyb, Wo, Wo, Wo
Wo, Wo, Wo, Wo, Wo, Wo, Wo, Rr, Ior, Xom, Ior, Rr, Wo, Wo, Wo, Rr, Ior, Ior, Ior, Rr, Wo, Wo, Wo
Wo, Wo, Wo, Wo, Wo, Wo, Wo, Rr^Vyb, Ior, Ior, Ior, Rr^Vyb, Wo^Bp\, Wo, Wo, Rr^Vyb, Ior, Ior, Ior, Rr^Vyb, Wo, Wo, Wo
Wo, Wo, Wo, Wo, Wo, Wo, Wo, Rr, Ior, Ior, Ior, Rr, Wo, Wo^Bp\, Wo^Bp\, Rr, Ior, Xom, Ior, Rr, Wo, Wo, Wo
Wo, Wo, Wo, Wo, Wo, Wo, Wo, Rr^Vyb, Ior, Xom, Ior, Rr^Vyb, Wo^Bp\, Wo, Wo, Rr^Vyb, Ior, Ior, Ior, Rr^Vyb, Wo, Wo, Wo
Wo, Wo, Wo, Wo, Wo, Wo, Wo, Rr, Ior, Ior, Ior, Rr, Wo, Wo^Bp\, Wo^Bp\, Rr, Ior, Ior, Ior, Rr, Wo, Wo, Wo
Wo, Wo, Wo, Wo, Wo, Wo, Wo, Rr^Vyb, Ior, Ior, Ior, Rr^Vyb, Wo, Wo, Wo, Rr^Vyb, Ce, Ce, Ce, Rr^Vyb, Wo, Wo, Wo
Wo, Wo, Wo, Wo, Wo, Wo, Wo, Rr, Ior, Ior, Ior, Rr, Wo, Wo, Wo, Rr, Ce, 1 Ke, Ce, Rr, Wo, Wo, Wo
Wo, Wo, Wo, Wo, Wo, Wo, Wo, Xom, Xom, Ior, Xom, Xom, Wo, Wo, Wo, Rr^Vyb, Icn, Ce, Icn, Rr^Vyb, Wo, Wo, Wo
Wo, Wo, Wo, Wo, Wo, Wo, Wo, Wo, Wo, Xom, Wo, Wo, Wo, Wo, Wo, Xom, Xom, Icn^Vyb, Xom, Xom, Wo, Wo, Wo
Wo, Wo, Wo, Wo, Wo, Wo, Wo, Wo, Wo, Wo, Wo, Wo, Wo, Wo, Wo, Wo, Wo, Xom, Wo, Wo, Wo, Wo, Wo
Wo, Wo, Wo, Wo, Wo, Wo, Wo, Wo, Wo, Wo, Wo, Wo, Wo, Wo, Wo, Wo, Wo, Wo, Wo, Wo, Wo, Wo, Wo
Wo, Wo, Wo, Wo, Wo, Wo, Wo, Wo, Wo, Wo, Wo, Wo, Wo, Wo, Wo, Wo, Wo, Wo, Wo, Wo, Wo, Wo, Wo
