Wo, Wo, Wo, Wo, Wo, Wo, Wo, Wo, Wo, Wo, Wo, Wo, Wo, Wo, Wo, Wo, Wo, Wo, Wo, Wo, Wo, Wo
Wo, Wo, Wo, Wo, Wo, Wo, Wo, Wo, Wo, Wo, Wo, Wo, Wo, Wo, Wo, Wo, Wo, Wo, Wo, Wo, Wo, Wo
Wo, Wo, Wo, Wo, Wo, Wo, Wo, Wo, Wo, Wo, Wo, Wo, Wo, Wo, Wo, Wo, Wo, Wo, Wo, Wo, Wo, Wo
Wo, Wo, Wo, Wo, Wo, Wo, Wo, Wo, Wo, Wo, Wo, Wo, Xom, Xom, Xom, Wo, Wo, Wo, Wo, Wo, Wo, Wo
Wo, Wo, Wo, Wo, Wo, Wo, Wo, Wo, Wo, Wo, Xom, Xom, Icn, Icn^Vyb, Icn, Xom, Xom, Wo, Wo, Wo, Wo, Wo
Wo, Wo, Wo, Wo, Wo, Wo, Wo, Wo, Wo, Wo, Xom, Icn^Vyb, Ce, Ce, Ce, Icn^Vyb, Xom, Wo, Wo, Wo, Wo, Wo
Wo, Wo, Wo, Wo, Wo, Wo, Wo, Wo, Rr^Vyb, Rr, Ior, Ior, Ce, 2 Ke, Ce, Icn, Xom, Wo, Wo, Wo, Wo, Wo
Wo, Wo, Wo, Wo, Wo, Wo, Rr^Vyb, Rr, Ior, Ior, Xom, Ior, Ior, Ce, Icn, Icn^Vyb, Xom, Wo, Wo, Wo, Wo, Wo
Wo, Wo, Wo, Wo, Rr^Vyb, Rr, Ior, Ior, Ior, Ior, Ior, Ior, Xom, Icn^Vyb, Xom, Xom, Wo, Wo, Wo, Wo, Wo, Wo
Wo, Wo, Xom, Rr, Ior, Ior, Ior, Xom, Ior, Ior, Rr^Vyb, Rr, Wo, Xom, Wo, Wo, Wo, Wo, Wo, Wo, Wo, Wo
Wo, Wo, Xom, Ior, Ior, Ior, Ior, Ior, Rr^Vyb, Rr, Wo^Bp|, Wo, Wo, Wo, Wo, Wo, Xom, Wo, Wo, Wo, Wo, Wo
Wo, Wo, Xom, Ior, Ior, Ior, Rr^Vyb, Rr, Wo^Bp|, Wo, Wo^Bp|, Wo, Wo, Wo, Rr^Vyb, Rr, Ior, Xom, Xom, Wo, Wo, Wo
Wo, Wo, Wo, Xom, Xom, Rr, Wo, Wo, Wo^Bp|, Wo, Wo^Bp|, Wo, Rr^Vyb, Rr, Ior, Ior, Ior, Ior, Xom, Wo, Wo, Wo
Wo, Wo, Wo, Wo, Wo, Wo, Wo, Wo, Wo^Bp|, Wo, Rr^Vyb, Rr, Ior, Ior, Ior, Xom, Ior, Ior, Xom, Wo, Wo, Wo
Wo, Wo, Wo, Wo, Wo, Wo, Wo, Wo, Rr^Vyb, Rr, Ior, Ior, Xom, Ior, Ior, Ior, Rr^Vyb, Rr, Wo, Wo, Wo, Wo
Wo, Wo, Wo, Wo, Wo, Wo, Rr^Vyb, Rr, Ce, Ior, Ior, Ior, Ior, Ior, Rr^Vyb, Rr, Wo, Wo, Wo, Wo, Wo, Wo
Wo, Wo, Wo, Wo, Wo, Xom, Icn, Ce, 1 Ke, Ce, Ior, Ior, Rr^Vyb, Rr, Wo, Wo, Wo, Wo, Wo, Wo, Wo, Wo
Wo, Wo, Wo, Wo, Wo, Xom, Icn^Vyb, Ce, Ce, Ce, Rr^Vyb, Rr, Wo, Wo, Wo, Wo, Wo, Wo, Wo, Wo, Wo, Wo
Wo, Wo, Wo, Wo, Wo, Xom, Xom, Icn, Rr^Vyb, Rr, Wo, Wo, Wo, Wo, Wo, Wo, Wo, Wo, Wo, Wo, Wo, Wo
Wo, Wo, Wo, Wo, Wo, Wo, Wo, Xom, Wo, Wo, Wo, Wo, Wo, Wo, Wo, Wo, Wo, Wo, Wo, Wo, Wo, Wo
Wo, Wo, Wo, Wo, Wo, Wo, Wo, Wo, Wo, Wo, Wo, Wo, Wo, Wo, Wo, Wo, Wo, Wo, Wo, Wo, Wo, Wo
Wo, Wo, Wo, Wo, Wo, Wo, Wo, Wo, Wo, Wo, Wo, Wo, Wo, Wo, Wo, Wo, Wo, Wo, Wo, Wo, Wo, Wo
Wo, Wo, Wo, Wo, Wo, Wo, Wo, Wo, Wo, Wo, Wo, Wo, Wo, Wo, Wo, Wo, Wo, Wo, Wo, Wo, Wo, Wo
