border_size=1
usage=map

Wo, Wo, Wo, Wo, Wo, Wo, Wo, Wo, Wo, Wo, Wo, Wo, Wo, Wo, Wo, Wo, Wo, Wo, Wo, Wo, Wo, Wo
Wo, Wo, Wo, Wo, Wo, Wo, Wo, Wo, Wo, Wo, Wo, Wo, Wo, Wo, Wo, Wo, Wo, Wo, Wo, Wo, Wo, Wo
Wo, Wo, Wo, Wo, Wo, Wo, Wo, Wo, Wo, Wo, Wo, Wo, Wo, Wo, Wo, Wo, Wo, Wo, Wo, Wo, Wo, Wo
Wo, Wo, Wo, Wo, Wo, Wo, Wo, Wo, Wo, Wo, Wo, Wo, Xuce, Xuce, Xuce, Wo, Wo, Wo, Wo, Wo, Wo, Wo
Wo, Wo, Wo, Wo, Wo, Wo, Wo, Wo, Wo, Wo, Xuce, Xuce, Re, Re, Re, Xuce, Xuce, Wo, Wo, Wo, Wo, Wo
Wo, Wo, Wo, Wo, Wo, Wo, Wo, Wo, Wo, Wo, Xuce, Re, Ce, Ce, Ce, Re^Wyb, Xuce, Wo, Wo, Wo, Wo, Wo
Wo, Wo, Wo, Wo, Wo, Wo, Wo, Wo, Rd, Rd, Re, Re, Ce, 2 Ke, Ce, Re, Xuce, Wo, Wo, Wo, Wo, Wo
Wo, Wo, Wo, Wo, Wo, Wo, Rd, Rd, Re, Re, Xuce, Re, Re, Ce, Re, Re, Xuce, Wo, Wo, Wo, Wo, Wo
Wo, Wo, Wo, Wo, Rd, Rd, Re, Re, Re, Re, Re, Re, Xuce, Re, Xuce, Xuce, Wo, Wo, Wo, Wo, Wo, Wo
Wo, Wo, Xuce, Rd, Re, Re, Re, Xuce, Re, Re, Rd^Wyb, Rd, Wo, Xuce, Wo, Wo, Wo, Wo, Wo, Wo, Wo, Wo
Wo, Wo, Xuce, Re, Re, Re, Re, Re, Rd^Wyb, Rd, Wo^Bh|, Wo, Wo, Wo, Wo, Wo, Xuce, Wo, Wo, Wo, Wo, Wo
Wo, Wo, Xuce, Re, Re, Re, Rd, Rd, Wo^Bh|, Wo, Wo^Bh|, Wo, Wo, Wo, Rd, Rd, Re, Xuce, Xuce, Wo, Wo, Wo
Wo, Wo, Wo, Xuce, Xuce, Rd, Wo, Wo, Wo^Bh|, Wo, Wo^Bh|, Wo, Rd, Rd, Re, Re, Re, Re, Xuce, Wo, Wo, Wo
Wo, Wo, Wo, Wo, Wo, Wo, Wo, Wo, Wo^Bh|, Wo, Rd^Wyb, Rd, Re, Re, Re, Xuce, Re, Re, Xuce, Wo, Wo, Wo
Wo, Wo, Wo, Wo, Wo, Wo, Wo, Wo, Rd^Wyb, Rd, Re, Re, Xuce, Re, Re, Re, Rd, Rd, Wo, Wo, Wo, Wo
Wo, Wo, Wo, Wo, Wo, Wo, Re, Rd, Ce, Re, Re, Re, Re, Re, Rd, Rd, Wo, Wo, Wo, Wo, Wo, Wo
Wo, Wo, Wo, Wo, Wo, Xuce, Re, Ce, 1 Ke, Ce, Re, Re, Rd, Rd, Wo, Wo, Wo, Wo, Wo, Wo, Wo, Wo
Wo, Wo, Wo, Wo, Wo, Xuce, Re, Ce, Ce, Ce, Rd, Rd, Wo, Wo, Wo, Wo, Wo, Wo, Wo, Wo, Wo, Wo
Wo, Wo, Wo, Wo, Wo, Xuce, Xuce, Re, Re, Rd, Wo, Wo, Wo, Wo, Wo, Wo, Wo, Wo, Wo, Wo, Wo, Wo
Wo, Wo, Wo, Wo, Wo, Wo, Wo, Xuce, Wo, Wo, Wo, Wo, Wo, Wo, Wo, Wo, Wo, Wo, Wo, Wo, Wo, Wo
Wo, Wo, Wo, Wo, Wo, Wo, Wo, Wo, Wo, Wo, Wo, Wo, Wo, Wo, Wo, Wo, Wo, Wo, Wo, Wo, Wo, Wo
Wo, Wo, Wo, Wo, Wo, Wo, Wo, Wo, Wo, Wo, Wo, Wo, Wo, Wo, Wo, Wo, Wo, Wo, Wo, Wo, Wo, Wo
Wo, Wo, Wo, Wo, Wo, Wo, Wo, Wo, Wo, Wo, Wo, Wo, Wo, Wo, Wo, Wo, Wo, Wo, Wo, Wo, Wo, Wo
