Wo, Wo, Wo, Wo, Wo, Wo, Wo, Wo, Wo, Wo, Wo, Wo, Wo, Wo, Wo, Wo, Wo, Wo, Wo, Wo, Wo, Wo
Wo, Wo, Wo, Wo, Wo, Wo, Wo, Wo, Wo, Wo, Wo, Wo, Wo, Wo, Wo, Wo, Wo, Wo, Wo, Wo, Wo, Wo
Wo, Wo, Wo, Wo, Wo, Wo, Wo, Wo, Wo, Wo, Wo, Wo, Wo, Wo, Wo, Wo, Wo, Wo, Wo, Wo, Wo, Wo
Wo, Wo, Wo, Wo, Wo, Wo, Xom, Xom, Rr^Vyb, Wo, Wo, Wo, Wo, Wo, Wo, Wo, Wo, Wo, Wo, Wo, Wo, Wo
Wo, Wo, Wo, Wo, Wo, Xom, Icn^Vyb, Icn, Ce, Rr, Rr^Vyb, Wo, Wo, Wo, Wo, Wo, Wo, Wo, Wo, Wo, Wo, Wo
Wo, Wo, Wo, Wo, Wo, Xom, Icn, Ce, 1 Ke, Ce, Ior, Rr, Rr^Vyb, Wo, Wo, Wo, Wo, Wo, Wo, Wo, Wo, Wo
Wo, Wo, Wo, Wo, Wo, Xom, Rr^Vyb, Ce, Ce, Ce, Ior, Ior, Ior, Rr, Rr^Vyb, Wo, Wo, Wo, Wo, Wo, Wo, Wo
Wo, Wo, Wo, Wo, Wo, Wo, Wo, Rr, Rr^Vyb, Ior, Ior, Ior, Xom, Ior, Ior, Rr, Rr^Vyb, Wo, Wo, Wo, Wo, Wo
Wo, Wo, Wo, Wo, Wo, Wo, Wo, Wo, Wo^Bw|, Rr, Rr^Vyb, Ior, Ior, Ior, Ior, Ior, Ior, Rr, Xom, Wo, Wo, Wo
Wo, Wo, Wo, Wo, Xom, Wo, Wo, Wo, Wo^Bw|, Wo, Wo^Bw|, Rr, Rr^Vyb, Ior, Ior, Xom, Ior, Ior, Xom, Wo, Wo, Wo
Wo, Wo, Xom, Xom, Ior, Rr, Rr^Vyb, Wo, Wo^Bw|, Wo, Wo^Bw|, Wo, Wo, Rr, Rr^Vyb, Ior, Ior, Ior, Xom, Wo, Wo, Wo
Wo, Wo, Xom, Ior, Ior, Ior, Ior, Rr, Rr^Vyb, Wo, Wo^Bw|, Wo, Wo, Wo, Wo, Rr, Xom, Xom, Wo, Wo, Wo, Wo
Wo, Wo, Xom, Ior, Ior, Ior, Ior, Ior, Ior, Rr, Rr^Vyb, Wo, Wo, Wo, Wo, Wo, Wo, Wo, Wo, Wo, Wo, Wo
Wo, Wo, Wo, Rr, Rr^Vyb, Ior, Ior, Xom, Ior, Ior, Ior, Rr, Xom, Xom, Xom, Wo, Wo, Wo, Wo, Wo, Wo, Wo
Wo, Wo, Wo, Wo, Wo, Rr, Rr^Vyb, Ior, Ior, Ior, Xom, Ior, Ior, Icn^Vyb, Icn, Xom, Xom, Wo, Wo, Wo, Wo, Wo
Wo, Wo, Wo, Wo, Wo, Wo, Wo, Rr, Rr^Vyb, Ior, Ior, Ior, Ce, Ce, Ce, Icn^Vyb, Xom, Wo, Wo, Wo, Wo, Wo
Wo, Wo, Wo, Wo, Wo, Wo, Wo, Wo, Wo, Rr, Xom, Ior, Ce, 2 Ke, Ce, Icn, Xom, Wo, Wo, Wo, Wo, Wo
Wo, Wo, Wo, Wo, Wo, Wo, Wo, Wo, Wo, Wo, Xom, Icn^Vyb, Icn, Ce, Icn, Icn^Vyb, Xom, Wo, Wo, Wo, Wo, Wo
Wo, Wo, Wo, Wo, Wo, Wo, Wo, Wo, Wo, Wo, Wo, Xom, Xom, Icn^Vyb, Xom, Xom, Wo, Wo, Wo, Wo, Wo, Wo
Wo, Wo, Wo, Wo, Wo, Wo, Wo, Wo, Wo, Wo, Wo, Wo, Wo, Xom, Wo, Wo, Wo, Wo, Wo, Wo, Wo, Wo
Wo, Wo, Wo, Wo, Wo, Wo, Wo, Wo, Wo, Wo, Wo, Wo, Wo, Wo, Wo, Wo, Wo, Wo, Wo, Wo, Wo, Wo
Wo, Wo, Wo, Wo, Wo, Wo, Wo, Wo, Wo, Wo, Wo, Wo, Wo, Wo, Wo, Wo, Wo, Wo, Wo, Wo, Wo, Wo
